a	一个
abandoned	被遗弃的
abandoner	遗弃者
abandoning	放弃
Abbey	修道院
Abby	艾比
ability	能力
able	能力
Able	能力
abnormality	异常
aboard	上
about	关于
About	关于
above	以上
abridgment	删节
abs	腹肌
absolute	绝对
absolutely	绝对
Absolutely	绝对
abuse	滥用
abyss	深渊
academy	学院
Academy	学院
accelerators	加速器
accent	口音
accents	口音
accept	接受
Accept	接受
accepted	接受
access	访问
accessible	可访问的
accessories	配件
accident	事故
accidentally	不小心
accompany	陪
accomplish	完成
according	根据
According	根据
account	账户
accountant	会计
accountants	会计师
accounts	账户
accross	飘去
accusing	指责
ace	王牌
Ace	王牌
ache	疼痛
achieved	实现
acknowledge	承认
acoustical	声
Acres	英亩
across	在
act	行为
Act	行为
acted	采取了行动
acting	代理
Acting	代理
action	行动
activity	活动
actor	演员
actors	演员
actress	女演员
actual	实际
actually	实际上
Actually	实际上
acually	说
acutally	其实
ad	广告
Adam	亚当
add	添加
added	添加
adding	添加
additional	额外的
address	地址
addressed	解决
addresses	地址
adds	增加了
Adelaide	阿德莱德
Adelman	阿德尔曼
Adidas	阿迪达斯
Adios	再见
adjustment	调整
administrator	管理员
admirer	崇拜者
admissions	入院
admit	承认
Admit	承认
admitting	承认
adopt	采用
adorable	可爱的
adore	崇拜
Adrian	艾德里安
Adrienne	艾德丽安
adult	成人
adults	成年人
advance	推进
advances	进步
advantage	优势
adventure	冒险
Adventure	冒险
advice	建议
advised	建议
adviser	顾问
aerobics	有氧运动
aff	著名
affair	事件
affect	影响
affected	影响
affection	感情
affirming	确认
afford	负担得起
afraid	害怕
Afraid	害怕
Africa	非洲
after	后
After	后
afternoon	下午
afternoons	下午
again	再一次
Again	再一次
against	对
Agamemnon	阿伽门农
age	年龄
Age	年龄
aged	岁的
ageist	年龄歧视
agency	机构
Agency	机构
agent	代理
agents	代理
aggressive	咄咄逼人的
Agh	啊
ago	前
agree	同意
agreed	同意
agreeing	同意
agreement	协议
agrees	同意
agressive	咄咄逼人的
ah	啊
Ah	啊
Ahahaha	啊哈哈哈
ahead	之前
ahem	嗯哼
Ahem	嗯哼
aid	援助
aim	目的
air	空气
Air	空气
airplane	飞机
Airplane	飞机
airport	机场
Airport	机场
aisle	过道
Alan	艾伦
Alans	艾伦
alarm	报警
Albany	奥尔巴尼
Albert	艾伯特
albino	白化
Albino	白化
album	专辑
albums	专辑
alcohol	酒精
alcoholic	含酒精的
alcoholics	酗酒者
Alda	艾达
Alec	亚历克
alert	警报
Alex	亚历克斯
Alexander	亚历山大
Algernon	阿尔杰农
Algonquin	阿冈昆
Alice	爱丽丝
alien	外星人
alignment	对齐
alike	都
alimony	赡养费
Alison	艾莉森
alive	活着
ALIVE	活着
all	所有
All	所有
allergic	过敏
alley	小巷
Alll	往歪道
allowed	允许
Allright	准确无误地
allways	老
almost	几乎
Almost	几乎
alone	独自一人
along	沿着
aloof	冷漠
alot	很多
alp	高山
alphabet	字母
already	已经
Already	已经
alright	好吧
Alright	好吧
alrighty	好的
Alrighty	好的
also	也
Also	也
altar	坛
altars	祭坛
altered	改变
altering	改变
alternate	备用
alternative	替代
Althea	蜀葵属植物
although	虽然
Although	虽然
altogether	完全
Alvin	阿尔文
always	总是
Always	总是
am	我
Am	我
Amanda	阿曼达
amateur	业余
amazes	很惊讶
amazing	令人惊异的
Amazing	令人惊异的
Amazingly	令人惊讶的是
Ambassador	大使
Amber	琥珀色的
ambitious	雄心勃勃的
Ameri	譬如
America	美国
American	美国
Amish	亚米希人
ammonia	氨
ammunition	弹药
amnesia	失忆
amnio	羊膜穿刺术
amount	量
Amsterdam	阿姆斯特丹
amused	逗乐
amusing	有趣的
Amy	艾米
an	一个
An	一个
anal	肛交
analytical	分析
Anchors	锚
anchovies	凤尾鱼
ancient	古老的
Ancient	古老的
and	和
And	和
Andie	干爹
Andre	安德烈
Andrea	安德里亚
Andrew	安德鲁
anecdotes	奇闻异事
Angela	安琪拉
Angeles	洛杉矶
anger	愤怒
angered	激怒了
angle	角
angry	愤怒的
animal	动物
Animal	动物
animals	动物
Animals	动物
anis	茴香酒
ankle	脚踝
ankles	脚踝
Ann	安
Annabelle	安娜贝拉
Annie	安妮
anniversaries	周年纪念
anniversary	周年纪念日
announced	宣布
announcement	公告
announcer	播音员
annoying	烦人的
annual	年度
Annual	年度
another	另一个
Another	另一个
answer	回答
Answer	回答
answered	回答
answering	回答
answers	答案
anthropologically	人类学上
anthropologists	人类学家
anticipation	期待
antique	古董
ants	蚂蚁
ANUS	肛门
anvil	铁砧
any	任何
Any	任何
anybody	任何人
Anybody	任何人
anymore	了
anyone	任何人
Anyone	任何人
anything	任何东西
Anything	任何东西
anytime	任何时候
Anytime	任何时候
anyway	无论如何
Anyway	无论如何
anyways	不管怎样
anywhere	在任何地方
Anywhere	在任何地方
apart	分开
apartment	公寓
apartments	公寓
apes	猿
Apes	猿
apiece	每人
apologise	道歉
apologize	道歉
apologizing	道歉
apology	道歉
Appalachia	阿巴拉契亚
appalled	震惊
appalling	骇人的
apparent	明显的
apparently	显然
Apparently	显然
appeal	上诉
appear	出现
Appearing	出现
appears	出现
appetisers	开胃菜
appetite	食欲
appetizer	开胃菜
applaud	鼓掌
apple	苹果
Apple	苹果
apples	苹果
application	应用程序
applying	应用
appointed	任命
appointment	任命
appointments	任命
appraise	评价
appreciate	欣赏
appreciated	欣赏
appreciates	赞赏
approaching	接近
approval	批准
approve	批准
approved	批准
apricots	杏子
apron	围裙
aprons	围裙
aptitude	资质
aquarium	水族馆
Arabian	阿拉伯
Aramis	阿拉米斯
architect	架构师
Arcola	之称
are	是
Are	是
area	区域
areas	区域
argue	认为
Argue	认为
argument	论点
arm	手臂
armless	无臂的
arms	武器
army	军队
Arnold	阿诺德
aroma	香气
Aroma	香气
aromatherapy	芳香疗法
around	周围
aroused	引起了
arrangements	安排
arrested	逮捕了
arrghh	惊讶
arrive	到达
arrived	到达
arrives	到达
arrogant	傲慢的
art	艺术
Art	艺术
arthritic	关节炎
Arthur	亚瑟
artichoke	洋蓟
article	文章
articles	文章
artificial	人工
artist	艺术家
Artistes	艺术家
artistic	艺术
as	作为
As	作为
ASAP	尽快
ash	灰
ashamed	羞愧
ashes	灰烬
Ashley	阿什利
aside	一边
Aside	一边
ask	问
Ask	问
asked	问
Asked	问
asking	问
asks	问
asleep	睡着了
asparagus	芦笋
aspirin	阿斯匹林
ass	屁股
Ass	屁股
assassin	刺客
assembling	组装
asses	驴
assign	分配
assistant	助理
Assistant	助理
assistants	助理
assorted	各种各样的
assume	假设
assuming	假设
assure	保证
assured	保证
asteroid	小行星
asthma	哮喘
astounding	令人震惊的
astronaut	宇航员
astronauts	宇航员
at	在
At	在
ate	吃了
Athens	雅典
Atlanta	亚特兰大
Atlantic	大西洋
atlas	阿特拉斯
ATM	自动取款机
atmosphere	大气
atom	原子
atomic	原子
atrium	中庭
Atta	阿塔
attach	附加
attachments	附件
attack	攻击
attend	参加
attended	参加了
attention	注意
attentive	细心的
attic	阁楼
attitude	的态度
attorney	律师
attracted	吸引了
attractive	有吸引力的
au	在
audience	观众
audition	试镜
auditioned	试镜
auditioning	试镜
auditions	试镜
auditorium	礼堂
aunt	阿姨
Aunt	阿姨
aura	之后
Aurora	极光
authentic	真实的
author	作者
authority	权威
Authority	权威
available	可用
avalanche	雪崩
avec	与
avenue	大道
Avenue	大道
aver	断言
average	平均
aversion	厌恶
avert	避免
avoid	避免
avoiding	避免
Aw	亚历山大
awake	醒着的
award	奖
Award	奖
Awards	奖
aware	意识到
away	走了
Away	走了
awesome	太棒了
awful	可怕的
Awful	可怕的
awfully	非常
awhile	一段时间
awkward	尴尬的
Awkward	尴尬的
Aye	啊
baaad	很糟糕
babbling	呀呀学语
babe	宝贝
babes	美女
babies	婴儿
Babies	婴儿
baby	婴儿
Baby	婴儿
BABY	宝贝
babysit	照顾
babysitter	保姆
babysitting	保姆
bachelor	本科
bachelors	单身汉
back	回来
Back	回来
BACK	回来
backed	支持
background	背景
backhand	反手
backing	支持
backpack	背包
backstage	后台
backup	备份
backward	落后的
backwards	向后
bacon	培根
bad	坏
Bad	坏
baddest	最坏的
Baddest	最坏的
baddie	反派角色
badges	徽章
badly	严重
badminton	羽毛球
bag	袋
Bag	袋
bagel	百吉饼
Bagel	百吉饼
bagels	百吉饼
baggage	行李
Baggage	行李
baggy	宽松的
bags	袋
baguette	法棍面包
bah	呸
BAH	呸
bail	保释
Bail	保释
bailed	援助
Bailey	贝利
bairly	拜尔
bait	诱饵
bake	烤
Bake	烤
baked	烤
bakery	面包店
Bakery	面包店
baking	烘焙
balance	平衡
balanced	平衡
balcony	阳台
bald	秃头
balded	秃头
Baldwin	鲍德温
ball	球
Ball	球
balled	粗心大意
Ballet	芭蕾舞
balloon	气球
balloons	气球
ballpark	球场
balls	球
Balls	球
ban	禁止
banana	香蕉
bananas	香蕉
band	乐队
Band	乐队
bang	爆炸
Bang	爆炸
banging	敲
bank	银行
banned	禁止
Banner	横幅
bar	酒吧
Barbara	芭芭拉
barbecue	烧烤
barbershop	理发店
Barbi	芭比
Barbra	芭芭
barely	几乎没有
Barely	几乎没有
barge	驳船
barium	钡
barley	大麦
Barley	大麦
barn	谷仓
barnyard	下流的
Barr	巴尔
barrel	桶
Barry	巴里
Barrymore	巴里摩尔
bars	酒吧
barter	物物交换
base	基地
baseball	棒球
baseboard	踢脚板
based	基于
Based	基于
Basel	巴塞尔协议
basement	地下室
bashing	抨击
basic	基本
basically	基本上
Basically	基本上
basil	罗勒
basing	基础
Basinger	贝辛格
basket	篮子
basketball	篮球
Basketball	篮球
Bass	低音
basset	巴塞特
bassinet	摇篮
bastard	混蛋
bat	蝙蝠
batch	批处理
Bates	贝茨
bath	浴
Bath	浴
bathing	洗澡
bathrobe	浴袍
bathroom	浴室
Bathroom	浴室
baths	洗澡
bathtub	浴缸
bats	蝙蝠
battery	电池
batting	击球
bay	湾
Bay	湾
Baywatch	贝手表
be	是
Be	是
BE	是
Bea	东亚银行
beach	海滩
Beach	海滩
beacon	灯塔
beads	珠子
beam	梁
Beam	梁
beaming	喜气洋洋的
bean	豆
Bean	豆
beans	豆子
Beans	豆子
Beanstalk	豆茎
bear	熊
Bear	熊
beard	胡子
bearer	持票人
bearers	持有者
bearings	轴承
bears	熊
beast	野兽
beasts	野兽
beat	击败
Beat	打
beaten	殴打
Beating	打
Beatty	比提
beause	因为
beautiful	美丽的
Beautiful	美丽的
beauty	美
became	成为
becasue	因为
Becasue	因为
because	因为
Because	因为
Beck	贝克
Becker	贝克尔
become	成为
Become	成为
becomes	就变成了
becoming	成为
becuase	因为
bed	床上
Bed	床上
bedroom	卧室
Bedroom	卧室
bedrooms	卧室
beed	以前
beef	牛肉
Beefsteak	牛排
been	被
beep	哔哔的声音
beeped	哔哔作响
beeper	蜂鸣器
beepers	呼机
beeps	哔哔声
beer	啤酒
Beer	啤酒
beers	啤酒
beetle	甲虫
Beetles	甲虫
before	之前
Before	之前
beforehand	事先
beg	求
begin	开始
beginning	开始
begins	开始
Begley	贝格利
begs	求
behalf	代表
behaves	的行为
behaviour	行为
behind	后面
Behind	后面
bein	傻
beind	下来
being	被
Being	被
belch	打嗝
Belgian	比利时
belief	信仰
believable	可信的
believe	相信
Believe	相信
believed	相信
believes	相信
believing	相信
belive	相信
bell	贝尔
Bell	贝尔
bellied	大肚子的
bellies	肚子
belly	肚子
bellyaching	抱怨
belong	属于
belongs	属于
belt	带
Ben	本
bend	弯曲
BEND	弯曲
beneath	下
benefit	好处
benign	良性的
Benny	本尼
bent	弯曲
beret	贝雷帽
Bergen	卑尔根
Bergman	伯格曼
Bermuda	百慕大
Bernice	柏妮丝
Bernie	伯尼
Berry	浆果
beside	旁边
besides	除了
Besides	除了
best	请接受我最美好的祝愿
Best	请接受我最美好的祝愿
bet	打赌
Bet	打赌
betcha	我打赌
Beth	贝丝
Bethel	伯特利
betray	背叛
betrayal	背叛
betrayed	背叛了
betraying	背叛
better	更好的
Better	更好的
betting	押注
Betty	贝蒂
between	之间的
beverage	饮料
beyond	除了
bha	底部钻具组合
Bible	圣经
biblical	圣经
Bicentennial	周年纪念
bicycle	自行车
big	大
Big	大
bigger	更大的
biggest	最大的
Bijan	毕扬
bike	自行车
bikini	比基尼
bill	比尔
Bill	比尔
billfold	皮夹子
bills	账单
Billy	比利
bimbo	女人
bing	必应
Bing	必应
binge	暴
binoculars	双筒望远镜
bionic	仿生
bird	鸟
Bird	鸟
birdie	小鸟
Birdie	小鸟
BIRDIE	小鸟
birdies	小鸟
birds	鸟
Birds	鸟
birth	出生
birthday	生日
Birthday	生日
birthdays	生日
births	出生
bisexuals	双性恋者
Bishop	主教
bit	位
Bit	位
bitch	婊子
Bitch	婊子
BITCH	婊子
bitched	抱怨
bite	咬
Bite	咬
biting	咬
bits	位
bitten	咬
bitter	苦
Bitter	苦
bitterest	痛苦的
bittersweet	苦乐参半的
black	黑色的
Black	黑色的
blackberry	黑莓
Blackberry	黑莓
blacked	涂黑
blackmailed	敲诈
blackout	停电
blacksmith	铁匠
bladder	膀胱
Bladder	膀胱
blade	叶片
blades	叶片
blah	废话
Blah	废话
blame	怪
blank	空白
blanket	毯子
blankets	毯子
blanks	空白
blast	爆炸
Blast	爆炸
blazed	开辟
blazer	上装
blazers	开拓者
bleach	漂白剂
bleed	流血
bleeding	出血
bless	祝福
blessing	祝福
blew	吹
blimey	啊呀
blind	盲目的
blinded	瞎了
blindness	失明
blinds	百叶窗
blink	眨眼
blinking	闪烁的
bloated	臃肿的
blobbies	点点
block	块
blockin	阻塞
blocking	阻塞
blocks	块
bloke	家伙
blond	金发碧眼的
blonde	金发女郎
blood	血
bloodbath	大屠杀
blooded	有血的
bloody	血腥的
Bloomingdale	卢明
Blossom	开花
blossoms	花朵
blouse	上衣
blouses	衬衫
blow	打击
Blow	打击
blower	鼓风机
Blowfish	河豚
blowin	随风飘荡
blowing	吹
blown	吹
blows	吹
blue	蓝色的
Blue	蓝色的
bluebells	蓝铃花
bluffing	虚张声势
blurry	模糊的
Bo	薄
board	董事会
boarding	登机
boat	船
boats	船
bob	鲍勃
Bob	鲍勃
bobbing	摆动
Bobby	鲍比
Bobcats	山猫
bodies	的身体
body	身体
boff	卖座的
Boggle	犹豫
boil	煮
boiler	锅炉
bold	大胆的
boles	博尔斯监管的
bologna	博洛尼亚
bolt	螺栓
bomb	炸弹
bombed	轰炸
bombs	炸弹
Bon	好的
Bona	博纳
bond	债券
Bond	债券
bonding	成键
bone	骨
boned	去骨
bonehead	笨蛋
bones	骨头
bonfire	篝火
bong	锣
Bong	锣
bonking	差异的
bonus	奖金
boob	女人的乳房
boobie	芭比
boobies	鲣鸟
boobs	乳房
boogie	不羁
book	书
Book	书
Bookbinder	装订商
Bookbinders	图书装订商
bookcase	书柜
booked	订了
books	书
bookstores	书店
boom	繁荣
booth	展位
boots	靴子
border	边境
borders	边界
bore	生
bored	无聊
Bored	无聊
boree	相思树
boring	无聊的
born	出生
borrow	借
borrowed	借来的
boss	老板
Boss	老板
bosses	老板
bossy	专横的
Boston	波士顿
botanist	植物学家
botanists	植物学家
both	这两个
Both	这两个
bother	麻烦
bothered	困扰
bothering	困扰
bothers	困扰
bottle	瓶
Bottle	瓶
bottles	瓶
bottom	底
bouche	嘴
bought	买了
bouncing	跳跃
bound	绑定
bouquet	花束
bout	端
Boutros	加利
bow	弓
Bow	弓
Bowe	鲍
bowl	碗
Bowl	碗
bowling	打保龄球
box	盒子
Box	盒子
boxer	拳击手
boxers	拳击手
boxes	盒子
Boxing	拳击
boy	男孩
Boy	男孩
boycotting	抵制
boyfriend	的男朋友
boyfriends	男朋友
boyish	孩子气的
Boyle	博伊尔
boys	男孩
Boys	男孩
bra	胸罩
brace	撑
bracelet	手镯
bracelets	手镯
bracket	支架
brag	吹牛
brain	大脑
brains	大脑
brainwaves	脑电波
Brake	刹车
branches	分支机构
brand	品牌
Brand	品牌
bras	手臂
Bras	手臂
brave	勇敢
Braverman	布雷弗曼
Brazilian	巴西人
bread	面包
Bread	面包
breadsticks	面包
break	打破
Break	打破
BREAK	打破
breakfast	早餐
Breakfast	早餐
breakin	打破
breaking	破坏
breaks	休息
breakthroughs	突破
breakup	分手
breast	乳房
breasts	乳房
breath	呼吸
breathe	呼吸
Breathe	呼吸
breathing	呼吸
breaths	呼吸
breeze	微风
breezy	活泼的
Brent	黑雁
Brian	布赖恩
bribe	贿赂
bribery	受贿
bricks	砖块
bride	新娘
Brides	新娘
bridesmaid	伴娘
bridesmaids	伴娘
Bridesmaids	伴娘
bridge	桥
Bridge	桥
Bridges	桥梁
brief	简要
briefcase	公文包
bright	亮
brighten	变亮
brightest	亮
brilliance	辉
brilliant	辉煌
brilliantly	出色
bring	带来
Bring	带来
bringing	使
Bringing	瞻
brings	带来
brisk	轻快
bristles	刷毛
British	英国的
Brittany	布列塔尼
Broadway	百老汇
broke	打破
broken	破碎
Broken	破碎
brook	溪
Brooklyn	布鲁克林
broom	扫帚
broth	肉汤
brother	哥哥
brothers	兄弟
brought	带
brown	棕色
Brown	棕色
brownies	布朗尼
Bruce	布鲁斯
bruise	挫伤
bruised	伤痕累累
Bruiser	卫兵
bruises	瘀伤
brunch	早午餐
brunette	黑发
brunt	首当其冲
brush	刷
brushed	刷
Brussels	布鲁塞尔
brutal	野蛮
Bryce	布莱斯
Bubba	布巴
bubble	气泡
Bubble	气泡
bubbles	泡泡
bubbling	冒泡
buck	降压
Buckingham	白金汉
buckles	扣
bucks	雄鹿
bud	芽
buddies	哥儿们
buddy	伙伴
Buddy	伙伴
budge	让步
budget	预算
buds	芽
Buffay	布菲
buffet	自助餐
bug	窃听器
bugged	窃听
bugger	开溜
bugs	虫子
Bugs	错误
Buh	乌兰布
build	建立
Build	建立
building	建造
Building	建造
buildings	房屋
built	内置
Built	内置
bullets	子弹
bullies	恶霸
Bullies	恶霸
bulls	公牛
Bullwinkle	布温克尔
bum	屁股
bumblebees	大黄蜂
bummed	郁闷
bummer	长号
Bummer	长号
bump	撞
bumped	被撞
bumper	保险杠
bumps	颠簸
bumpy	颠簸
Bumpy	颠簸
bun	包子
bunch	束
Bunch	束
bunk	铺位
bunnied	兔子
bunnies	兔子
bunny	兔子
Bunny	兔子
buns	包子
Buon	奔
burden	负担
burg	伯格
burgendy	勃艮第
burger	汉堡包
Burger	汉堡包
burgers	汉堡
burgundy	勃艮第
burial	葬礼
buried	隐藏
Buried	隐藏
buries	埋地
Burke	伯克
burlesque	滑稽戏
burly	结实
Burma	缅甸
burn	烧伤
Burn	烧伤
burned	烧
burners	刻录机
burnin	燃尽
burning	燃烧
Burning	燃烧
burns	烧伤
burnt	焦
burring	毛刺
burst	爆
bus	总线
buses	公共汽车
busiest	最繁忙
business	商业
businesses	企业
bust	胸围
busted	破获
busting	破坏
busy	忙
but	但
But	但
buts	的击打
butt	屁股
Butt	屁股
butter	牛油
buttered	黄油
Butterscotch	奶油
buttock	臀部
button	按键
Buttons	纽扣
butts	烟头
buy	购买
Buy	购买
buyer	买方
buying	购买
buys	购买
buzz	蜂鸣器
Buzz	蜂鸣器
buzzed	嗡嗡嗡
buzzer	蜂鸣器
by	通过
By	通过
BY	通过
bye	再见
Bye	再见
byes	轮空
Ca	钙
cab	出租车
Cab	出租车
Cabana	小屋
cabin	舱
Cabin	舱
cabinet	内阁
cabinets	橱柜
cable	电缆
cabs	出租车
cache	高速缓存
Cache	高速缓存
Cadillac	卡迪拉克
Cafe	咖啡店
cafeteria	自助餐馆
Caffe	咖啡
cage	笼
Cailin	才林
Cajun	印第安
cake	蛋糕
Cake	蛋糕
cakes	蛋糕
California	加州
call	呼叫
Call	呼叫
callback	打回来
called	叫
caller	呼叫者
Caller	呼叫者
callin	呼唤
calling	调用
Calling	调用
calls	电话
calm	冷静
Calm	冷静
calming	平静
calves	小牛
Calvin	卡尔文
Cambodia	柬埔寨
came	来了
camera	相机
Camera	相机
cameras	相机
Camomile	甘菊
camp	营
campaign	运动
camped	扎营
camper	露营
camping	露营
can	能够
Can	能够
Canada	加拿大
Canadian	加拿大
Canadians	加拿大人
cancel	取消
canceled	取消
cancelled	取消
cancelling	取消
cancer	癌症
candidate	候选人
candle	蜡烛
candles	蜡烛
candy	糖果
Candy	糖果
canidates	候选人
canna	美人蕉
canned	听装
cannon	大炮
canoe	独木舟
cans	罐
cant	斜面
Cantaloupe	哈密​​瓜
cantelope	香瓜
canvas	帆布
cap	帽
capabilities	功能
capable	能
capacity	容量
cape	岬
capital	首都
Capital	首都
cappuccino	热奶咖啡
Cappuccino	热奶咖啡
cappucino	热奶咖啡
caps	帽子
captain	队长
Captain	队长
captains	船长
captured	捕获
capuchan	僧帽
capuchian	僧帽
car	汽车
Car	汽车
carbon	碳
carcass	胴体
card	卡
Card	卡
cards	牌
care	关心
Care	关心
cared	照顾
career	事业
Career	事业
careers	职业生涯
careful	小心
Careful	小心
carefully	小心
caregiver	护理人员
cares	管它
caress	抚摸
Carin	凯琳
caring	爱心
Caring	关怀
Carl	卡尔
Carlin	卡林
Carlos	卡洛斯
Carney	卡尼
carnivore	肉食动物
caro	卡罗
Carol	颂歌
Carols	颂歌
carpaccio	卡尔帕乔
carpel	心皮
carpet	地毯
Carpet	地毯
carried	携带的
carries	携带
carrot	胡萝卜
carry	携带
Carry	携带
carrying	携带
carryon	继续
cars	汽车
carseat	汽车座椅
cart	大车
carton	纸板箱
cartons	纸箱
cartoon	动画片
cartoons	卡通
carts	车
carve	雕刻
casa	卡萨
Casa	卡萨
case	案件
cases	例
Casey	卡西
cash	现金
cashmere	开司米
casket	棺材
casserole	沙锅
cast	投
casting	铸件
casts	铸件
casual	随便
casually	胡乱
cat	猫
Cat	猫
catalog	目录
catalogue	目录
cataract	白内障
catch	抓住
Catch	抓住
catches	渔获
catching	捕
categories	类别
categorizes	分类
category	类别
cater	迎合
catered	照顾
caterer	餐饮服务商
caterers	餐饮业
catergories	类别
catering	餐饮业
catfish	鲶鱼
Catholic	天主教徒
Cathy	凯茜
cats	猫
Cats	猫
caught	抓住
cause	原因
'cause'	原因
Cause	原因
causes	原因
caution	警告
cave	洞穴
caved	下陷
CD	光盘
ceiling	天花板
ceilings	天花板
celantro	胡荽叶
celebrate	庆祝
Celebrate	庆祝
celebrating	庆祝
celebration	庆典
celebrities	名人
Celebrities	名人
celery	芹菜
Celia	西莉亚
Celica	赛利卡
cell	细胞
cellar	地窖
cellars	酒窖
celled	单细胞
cello	大提琴
cellular	细胞的
Celtics	凯尔特人
cent	一分钱
center	中央
Center	中央
centimeters	公分
Central	中央
cents	仙
century	世纪
Century	世纪
ceramic	陶瓷的
cereal	谷类
cereals	谷物
ceremony	仪式
certain	某些
certainly	当然
cervix	宫颈
cha	茶
Cha	查
Chachi	恰
Chad	乍得
chair	椅子
chairs	椅子
chalk	粉笔
challenge	挑战
Challenge	挑战
challenged	挑战
champ	冠军
champagne	香槟酒
Champion	冠军
championship	锦标赛
Championship	锦标赛
champs	香榭丽舍大街
Chan	陈
chance	机会
chances	机会
Chances	机会
Chand	昌德
chandelier	吊灯
Chandelier	吊灯
chandler	钱德勒
Chandler	钱德勒
Chandy	尚迪
Chanel	香奈儿
change	更改
Change	更改
changed	变
changer	换
changes	变化
changin	起了变化
changing	改变
Chanlder	钱德勒
channel	渠道
Channel	渠道
channels	渠道
chant	呗
Chantal	尚塔尔
Chanukah	光明节
chaotic	混乱的
Chap	皴裂
chapter	章节
character	字符
characters	人物
charcoal	木炭
charge	收费
charged	带电
charging	充电
charity	慈善机构
Charity	慈善机构
Charles	查尔斯
Charlie	查理
Charlotte	夏洛特
Charlton	查尔顿
charm	魅力
charming	迷人
charms	魅力
charred	焦
chart	图表
chase	追
chased	追
chasing	追
Chasing	追逐
chat	聊
chateau	城堡
cheap	廉价
cheaper	便宜
cheat	作弊
cheated	被骗
cheater	骗子
Cheater	骗子
cheaters	骗子
cheating	作弊
check	校验
Check	校验
checkbook	支票簿
checked	检查
checkin	报到
Checkin	报到
checking	检查
Checking	检查
checks	检查
cheddar	切达乳酪
Cheech	切奇
cheek	脸颊
cheeks	脸颊
cheer	欢呼
cheerleader	拉拉队长
cheers	干杯
Cheers	干杯
cheese	起司
Cheese	起司
cheeseburger	乳酪汉堡
cheesecake	芝士蛋糕
chef	厨师
Chef	厨师
chefs	厨师
Chelsea	切尔西
chemical	化学
chemistry	化学
cheques	检查
cherries	樱桃
cherry	樱桃
Cherry	樱桃
Cheryl	谢丽尔
chest	胸部
Chester	切斯特
chestnuts	栗子
chewing	咀嚼
chews	嚼
chi	志
Chi	驰
Chicago	芝加哥
chick	小鸡
Chick	小鸡
chicken	鸡
Chicken	鸡
chickened	缩头
chickens	鸡
chickpea	鹰嘴豆
chicks	小鸡
Chicks	小鸡
Chico	奇科
Chief	首席
chiefs	酋长
child	儿童
childhood	童年
children	孩子
Children	孩子
childrens	儿童
Chilean	智利
chilie	智利
chill	寒意
chilliest	寒冷的
chimney	烟囱
chimps	黑猩猩
chin	下巴
china	中国
China	中国
Chinese	中文
ching	清
chino	奇诺
chip	芯片
Chip	芯片
chipmunk	花栗鼠
chipped	缺口
chipper	削片机
Chipper	削片机
chippy	花栗鼠
chips	芯片
chiropractor	按摩师
chirping	鸣叫
chit	保单
chiuaua	奇瓦瓦
Chloe	克洛伊
chocolate	巧克力
chocolatey	巧克力味
choice	选择
Choice	选择
choices	选择
choke	呛
choked	哽咽
choking	窒息的
choose	选择
choosing	选择
chop	劈
chopped	切碎的
Chopper	断路器
choppered	用直升机
chopsticks	筷子
chords	和弦
chorizo	香肠
choruses	合唱
chose	选择
chosen	选择
chou	周杰伦
Chris	克里斯
Chrissy	克丽丝
christening	洗礼
Christian	基督教
Christine	克里斯汀
Christmas	圣诞
Chrysler	克莱斯勒
chubby	丰满的
Chuck	查
Chuckles	咯咯笑
Chucky	查基
Chunky	矮胖
chute	斜道
Ciao	再见
cider	苹果酒
cigar	雪茄
cigarette	香烟
Cigarette	香烟
cigarettes	香烟
Cigarettes	香烟
cigars	雪茄
cilantro	胡荽叶
Cilantro	胡荽叶
Cincinnati	辛辛那提
Cindy	辛迪
CinemaxCinemax	在
cinnamon	肉桂
Cinnamon	肉桂
circle	圈
Circle	圈
circles	界
circling	盘旋
circumstances	情况
circus	马戏团
Circus	马戏团
cities	城市
Cities	城市
Citizen	公民
city	市
City	市
CIty	市
civil	国内
Civil	国内
claim	要求
claimed	声称
claims	索赔
clarify	澄清
clarinet	单簧管
Clark	克拉克
class	类
classes	类
classic	经典
classics	经
classifieds	公告
classs	班组长
classy	优雅
Claude	克劳德
Claus	克劳斯
Clause	条款
claws	爪
Claws	爪
clay	粘土
Claymation	粘土动画
clean	清洁
Clean	清洁
cleaned	清洗
cleaners	清洁工
cleaning	清洁的
cleans	清理
cleansing	净化
Cleansing	净化
clear	明确
Clear	明确
clearer	更清晰
clearly	明确地
Clearly	明确地
cleavage	分裂
clench	咬紧
clenches	握紧
clenching	紧咬
Cleveland	克利夫兰
clever	聪明
clich	老生常谈
click	点击
clicked	点击
clicking	点击
client	客户
clients	客户
Cliff	悬崖
climb	爬
climbing	攀登
cling	依偎
clingy	紧贴
clinic	诊所
clink	碰杯
Clint	克林特
Clinton	克林顿
clip	夹
clipped	修剪
clobbered	重挫
clock	时钟
clocked	主频
clocks	时钟
Clockwork	发条装置
clogged	堵塞
clogging	堵塞
clogs	木底鞋
Clogs	木底鞋
close	关
Close	关
closed	关闭
Closed	关闭
closely	密切
closeness	亲近
closer	接近
Closer	言归正传
closes	关闭
closest	最近的
closet	壁橱
closets	壁橱
closing	关闭
CLOSING	闭幕
closure	关闭
Closure	关闭
closures	关闭
cloth	布
clothes	衣服
clothing	服装
clown	小丑
Clown	小丑
clowns	小丑
club	俱乐部
clubbing	泡吧
clubs	会所
clue	线索
clunky	笨重
cluster	簇
clusters	集群
c'mon	来吧
C'mon	来吧
C'MON	来吧
co	合作
coach	教练
coached	执教
coaches	教练
coaching	教练
coal	煤
coast	滨
coaster	杯垫
coat	涂层
coats	大衣
cobb	科布
Cobb	科布
cobbler	皮匠
cocaine	可卡因
cockpit	座舱
cocktail	鸡尾酒
cocktails	鸡尾酒
cocoa	可可
coconut	椰子
Cocoon	茧
code	码
codependent	相互依赖
Cody	科迪
coffee	咖啡
Coffee	咖啡
coffeehouse	咖啡屋
coffees	咖啡
coffin	棺材
coin	硬币
coincidence	巧合
Coincidence	巧合
coincidences	巧合
Coke	可乐
cola	可乐
cold	冷
cole	油菜
Colin	科林
collapsed	倒塌
collar	领
collating	整理
collect	搜集
collected	集
collection	采集
college	学院
College	学院
collie	牧羊犬
Collins	柯林斯
cologne	科隆
colon	结肠
Colonel	陆军上校
Colonial	殖民
colony	殖民地
color	颜色
colored	有色
colorful	华美
coloring	染色
colors	颜色
colour	颜色
coloured	有色
colours	颜色
column	柱
coma	昏迷
Coma	昏迷
comb	梳子
combination	组合
combine	结合
combines	联合收割机
Combo	二合一
come	来
Come	来
comedian	喜剧演员
comedy	喜剧
comes	来
comfort	安慰
comfortable	自在
comics	漫画
comin	科曼
Comin	今儿
coming	未来
command	命令
commando	别动队
commencement	开始
comments	评论
commercial	广告
Commercial	广告
commercials	广告
commission	佣金
commitment	承诺
committed	提交
committee	委员会
committees	委员会
committing	提交
Commodore	准将
common	共同
communicating	通信
Communism	共产主义
community	社区
companies	公司
company	公司
Company	公司
compare	相比
compared	相比
compartments	车厢
compass	罗盘
compensate	补偿
compete	竞争
competition	竞争
competitive	竞争的
complain	抱怨
complaining	抱怨的
complaints	投诉
complement	补充
complementary	补充
complete	完成
completely	全然
complex	复杂
complicated	复杂
complication	并发症
comprehend	理解
comprehends	领悟
compromise	妥协
compulsion	义务
compulsive	强迫
compulsively	强制
Computech	科网络
computer	电脑
concealed	暗
conceivable	可以想象
conceive	构想
concentrate	浓缩
concentration	浓度
concentric	同心
concept	概念
concern	关心
concerned	关心
concert	音乐会
conclusion	结论
conclusions	结论
concussion	震动
condensation	缩合
condescending	居高临下
condition	条件
conditions	条件
condo	公寓
condom	避孕套
condoms	避孕套
Condoms	避孕套
conduct	进行
conducting	开展
cone	锥体
cones	锥
conference	会议
confess	承认
confetti	五彩纸屑
confidant	知己
confident	信心
confirmed	确认
confiscation	征用
confrontation	对抗
confrontational	对抗性
confronted	面对
confuse	迷惑
confused	困惑
congratulate	祝贺
congratulation	祝贺
congratulations	祝贺
Congratulations	祝贺
Congress	国会
Congressman	众议员
connect	连
connected	连接的
Connecticut	康涅狄格
connection	连接
conquer	征服
conquered	征服
cons	缺点
conscious	意识
consider	考虑
Consider	考虑
considered	考虑
considering	考虑
consolation	安慰
constant	不变
constantly	经常
construction	施工
constructive	建设性
consummated	完善
contact	联系
Contact	联系
containers	集装箱
contest	比赛
continue	继续
continuing	继续
contract	合同
contraction	收缩
contractions	宫缩
contribution	贡献
control	控制
Control	控制
controlled	受控
conventional	常规
conversation	会话
convertible	可兑换
convey	传达
convince	说服
convinced	相信
convinces	说服
convincing	使人信服
Coo	鸪鸪声
cook	厨师
Cook	厨师
cookbooks	食谱
cooked	熟
cookie	曲奇饼
Cookie	曲奇饼
cookies	饼干
Cookies	饼干
cooking	烹饪
Cooking	烹饪
cooks	厨师
cool	凉
Cool	凉
cooler	冷却器
coolest	最酷
cooling	冷却
Cooper	库珀
cooperation	合作
cop	警察
Cop	警察
Copa	科帕
copied	复制
copier	复印机
copies	副本
Copperfield	科波菲尔
cops	警察
copy	复制
copying	仿形
cord	绳
corn	玉米
cornea	角膜
corner	角
cornered	走投无路
corners	角落
corny	老生常谈
corporate	企业
corporation	公司
corpses	尸体
correct	正确
Correct	正确
correctly	正确地
correspondence	对应
Cosmo	科斯莫
cost	成本
Costalano	卡斯特拉诺
costing	成本核算
costs	成本
costume	服装
costumes	服装
Cotter	科特
cotton	棉
cou	腠
couch	长椅
Cougar	美洲狮
cough	咳嗽
Cough	咳嗽
could	可以
Could	可以
couldn't	不能
counselor	参赞
count	计数
Count	计数
countdown	倒数
counted	计
counter	计数器
counting	数数
countries	国家
country	国家
Country	国家
counts	计数
county	县
County	县
coupla	弄点
couple	一对
couples	情侣
coupon	优惠券
coupons	优惠券
courage	勇气
course	课程
Course	课程
court	法庭
courthouse	法院
courtroom	法庭
courtside	场边
cousin	表姐
cousins	表兄弟
cover	覆盖
Cover	覆盖
coveralls	工作服
covered	覆盖
covering	覆盖
covers	盖子
cow	牛
cowboy	牛仔
Cowboys	牛仔
cows	奶牛
coyotes	小狼
crab	螃蟹
crabby	倔
Crabby	倔
Crabtree	克拉布特里
crack	裂纹
cracked	破解
cracker	饼干
crackers	饼干
cracking	开裂
cracks	裂缝
craftsmanship	手艺
cramp	抽筋
Cramp	抽筋
cramps	抽筋
cranberry	酸果蔓
cranial	颅
cranky	胡思乱想的
crap	掷骰子
crappy	蹩脚的
crash	紧急
crashed	坠毁
craving	瘾
cravings	渴望
Crawford	克劳福德
crawled	爬
crawler	履带式
crawls	爬行
craziest	疯狂
crazy	疯
Crazy	疯
cream	奶油
creamier	奶味更浓
crease	皱
create	创建
creating	创建
creation	创建
creature	生物
creatures	生物
credit	信用
Credit	信用
credited	记
CREDITS	学分
creep	爬行
creepers	攀缘植物
creepin	情不自禁
creeps	蠕动
creepy	爬行
creme	奶油
Cretasous	白垩纪
Crew	船员
cried	哭了
cries	哭声
crime	犯罪
crimes	犯罪
crisis	危机
crisp	脆
crispy	香脆
Cristmas	圣诞
critic	评论家
critical	危急
critics	批评者
croissant	新月形面包
crooked	歪
crop	作物
cross	交叉
crossbow	弩
crossed	越过
crossing	路口
Crossroads	十字路口
crossword	填字游戏
crotch	裆
croup	臀部
crowded	挤
crown	王冠
crowning	加冕
crudites	蔬菜沙拉
cruel	残忍
cruelty	残酷
Cruise	巡航
crumb	屑
crumbles	崩溃
crumpled	皱巴巴
Crunch	紧缩
crunchy	脆脆
crush	粉碎
crushed	碎
crust	脆皮
crusty	硬皮
cry	哭
Cry	哭
crying	哭了
crystal	水晶
Crystal	水晶
cub	幼兽
Cub	幼兽
Cuba	古巴
Cubans	古巴人
cubby	玩具小屋
cube	立方体
cubicle	柜
cucumber	黄瓜
cuddle	搂抱
cuddled	拥抱
cuddling	拥抱
cuff	袖口
cufflinks	袖扣
cuffs	袖口
cultivating	培育
cultures	文化
Cunningham	坎宁安
cup	杯子
Cup	杯子
Cupid	丘比特
Cupping	拔罐
cups	杯
curator	馆长
curb	抑制
curiosity	好奇心
curious	好奇
Curious	好奇
curiously	好奇
curl	卷曲
curling	卷曲
curly	卷曲
Curly	卷曲
current	当前
currently	目前
curry	咖喱
Curry	咖喱
curse	诅咒
cursed	诅咒
curtain	窗帘
curtains	窗帘
cushion	垫子
cushions	靠垫
Cushions	靠垫
custard	卡仕达酱
Custer	卡斯特
customer	顾客
customers	顾客
customs	海关
cut	切
Cut	切
cute	可爱
Cute	可爱
cuter	可爱
cutest	可爱
cutie	可爱
cuts	削减
cutting	切割
cycle	周期
'd	倒是
Da	达
dab	轻拍
dad	爸
Dad	爸
daddy	爸
Daddy	爸
dads	爸爸
Dah	长音
daily	日常
dainty	纤巧
dairy	乳制品
Dairy	乳业
Dakota	达科他州
damage	损伤
Damme	达默
dammit	该死
Dammit	该死
damn	该死的
Damn	该死的
damned	该死
damnit	该死的
Damnit	该死的
Damone	达摩尼
Dan	担
Dana	达纳
dance	舞蹈
Dance	舞蹈
danced	跳舞
dancer	舞蹈家
dancers	舞者
dances	舞蹈
Dances	舞蹈
dancing	跳舞
Dancing	跳舞
dancy	丹西
dangerous	危险
Dangerous	危险
dangle	垂
Daniel	丹尼尔
Danielle	丹妮尔
Danny	丹尼
dare	敢
dark	暗
Dark	暗
darkness	黑暗
darling	宠儿
Darling	宠儿
darn	紩
Darn	紩
dart	镖
Dartmouth	达特茅斯
darts	飞镖
Darwin	达尔文
Daryl	达里尔
dash	短跑
dashing	潇洒
data	数据
datable	确定时代
date	日期
Date	日期
dated	过时的
dates	日期
dating	约会
daughter	女儿
Dave	戴夫
David	大卫
Davis	戴维斯
day	天
Day	天
DAY	天
daydreaming	白日梦
days	天
Days	天
daytime	白天
de	德
dead	死
Dead	死
deadened	消音
deadline	最后期限
deaf	聋
deal	合同
Deal	合同
dealer	零售商
Dealer	零售商
dealers	经销商
dealership	经销商
dealing	交易
dealt	处理
Dean	院长
dear	亲
Dear	亲
death	死亡
Death	死亡
deathbeds	临终
Deb	德布
debating	辩论
Debbie	黛比
debloons	杜布隆
Debra	黛布拉
debt	债务
debut	登场
decaf	无咖啡因
Decaf	无咖啡因
December	十二月
decent	正经
deceptively	迷惑
decide	决定
Decide	决定
decided	决定
decides	决定
deciding	决定
decision	决定
decisions	决定
deck	甲板
declarations	声明
declare	宣布
deconstructing	解构
decorate	装饰
decorated	装饰
decorating	装潢
dedicated	专用
Dee	迪伊
deep	深
Deeper	更深的
deeply	深
deer	鹿
deerhunter	迪尔特
defence	防御
defended	辩护
defense	防御
defiantly	对抗地
deficit	赤字
definately	肯定
define	限定
Define	限定
definite	定
definitely	无疑
Definitely	无疑
definitive	明确
degrading	降解
degree	学位
dehydrate	脱水
Dehydrated	脱水
dehydrating	脱水
deities	神佛
deja	似曾相识
delicacy	美味
delicate	精巧
delicates	精细织物
delicious	美味的
deliver	交付
delivered	交付
delivery	交货
Delivery	交货
Delvecchio	德尔维奇奥
demand	需求
DeMarco	德马科
demeaning	贬低
Demi	黛咪
demo	演示
demonstrate	演示
den	巢穴
denial	否认
denied	否认
denim	牛仔布
Denise	丹尼斯
denizen	常客
Dennis	丹尼斯
dense	稠密
dental	牙齿
dented	凹
dentist	牙医
dentists	牙医
dents	凹痕
deny	拒绝
denying	否认
department	部门
Department	部门
depend	依靠
dependent	依赖的
depends	要看
depressed	郁闷
depressing	沉闷
depression	萧条
depriving	剥夺
depths	深处
descent	降落
describe	描述
described	描述
describes	介绍
deserve	值得
deserves	值得
Design	设计
designed	设计
designer	设计师
designers	设计师
desk	台
Despair	绝望
desperate	殊死
desperately	拼命
desperation	绝望
despite	尽管
dessert	甜点
destiny	命运
Destiny	命运
destroy	破坏
destroyed	销毁
destroying	销毁
destroys	破阵
destructive	有害
detail	详情
details	细节
detergent	洗涤剂
devastated	满目疮痍
develop	开发
deviated	偏离
device	设备
devil	魔鬼
devoid	没有
Devon	德文
devote	奉献
Dexter	德克斯特
di	迪
dial	拨号
dialed	拨打
dialer	拨号器
dialing	拨号
dialogue	对话
diamond	钻石
diaper	尿布
diapers	尿布
diaphram	光圈
diary	日记
Diary	日记
dice	骰子
dicey	冒险的
dicing	切割
Dick	迪克
Dickens	狄更斯
dictator	独裁者
did	没有
Did	难道
die	死
Die	死
died	死亡
Diego	迭戈
dies	死
diet	饮食
Diet	饮食
diffency	不足
differ	不同
difference	区别
different	不同
differently	不同
difficult	难
difficulty	困难
dig	挖
Digest	消化
digests	摘要
digging	挖掘
digital	数字
dignity	尊严
Dillon	狄龙
dim	暗淡
dime	十分钱
dimension	尺寸
dimensional	尺寸的
dimmer	调光器
Dina	迪娜
Dinah	黛娜
diner	餐车
Diner	餐车
ding	丁
Ding	丁
dingle	丁格尔
dingy	灰溜溜
dining	用餐
dinner	晚餐
Dinner	晚餐
dinners	晚餐
Dino	迪诺
dinosaur	恐龙
dinosaurs	恐龙
dip	蘸
diploma	文凭
diplomat	外交官
diplomatic	外交
dips	骤降
dire	可怕的
direct	直接
direction	方向
directly	直
director	导向器
dirt	污垢
dirty	脏
disability	失能
disagreement	异议
disappeared	消失
disappears	消失
disappointed	失望
disappointment	失望
disarray	弄乱
disaster	灾害
disbelief	怀疑
disc	圆盘
Disclosure	泄露
disco	迪斯科
disconnected	断开的
discount	折扣
Discover	发现
discovered	发现
Discoveries	发现
Discovery	发现
discuss	讨论
discussed	讨论
discussion	讨论
disease	疾病
disgusted	厌恶的
disgusting	讨厌
dish	碟
dishes	碗碟
disk	磁盘
dislike	反感
dislikes	不喜欢
dismantle	拆除
dismiss	解雇
dismissed	驳回
Disneyland	迪斯尼乐园
display	显示
disrespectful	不恭
distance	距离
distant	遥远
distract	转移
distraction	娱乐
distraught	发狂的
disturb	干扰
disturbing	烦扰的
ditch	沟渠
ditto	同上
Ditto	同上
ditzyditzy	的
dive	潜水
Diverse	多种
diversion	导流
divide	划分
divided	分为
division	师
Division	师
divorce	离婚
divorced	离婚
divulge	泄露
d'knowD'	知道
d'mentheD'	薄荷
do	做
Do	做
DO	做
Doc	文件
docile	温顺
dock	码头
docks	码头
doctor	医生
Doctor	医生
doctoral	博士生
doctors	医生
Doctors	医生
documentary	记录
Doe	母鹿
does	不
Does	是否
doesnt	犯规
dog	狗
Dog	狗
dogged	困扰
doggie	狗
dogs	小狗
D'ohD'	哦
doin	杜安
doing	干
Doing	干
doll	娃娃
dollar	美元
dollars	美元
Dollars	美元
dollhouse	玩具屋
dollies	推车
dolls	玩偶
Dom	大教堂
dominates	占主导地位
Donald	唐纳德
donated	捐赠
donating	捐赠
Done	完成
dong	东
Donna	唐娜
donor	捐赠者
dont	别
donut	甜甜圈
donuts	甜甜圈
Doo	斗
doodle	涂鸦
doody	杜迪
Doody	杜迪
doof	笨蛋
doom	厄运
Doom	厄运
doomed	注定
door	门
doorknobs	门把手
doorman	看门人
doors	门
doorstep	门阶
Dope	涂料
Dora	多拉
Dorf	多夫
Dorfman	多尔夫曼
Doritos	多力多滋
dork	白痴
dorky	学究气
dormant	休眠
dorms	宿舍
Dorothy	多萝西
dot	点
double	双
doubt	怀疑
Doubtfire	肥妈
Doubtful	疑
Doug	道格
dough	面团
Dough	面团
Douglas	道格拉斯
Dowdy	寒酸的
down	下
Down	下
downs	起伏
downstairs	楼下
dozen	打
dozens	许多
Dr	博士
draddle	节
draft	草案
drag	拖动
dragged	拖
dragging	拖延
dragon	龙
Dragon	龙
drain	排水
Drake	鸭
drama	戏剧
drank	喝
draw	画
Draw	画
DRAW	画
drawer	抽屉
drawings	图纸
drawn	画
dreadful	可怕
dreading	害怕
dream	梦想
dreamed	梦见
dreaming	做梦
dreams	梦
dreamy	梦想的
dress	连衣裙
dressed	连衣裙的
dresser	梳妆台
dresses	礼服
dressing	敷料
dressy	考究
drew	德鲁
Drew	德鲁
dried	干
drift	漂移
drifted	漂流
drill	钻头
drink	喝
drinker	酒徒
drinkin	边喝边
drinking	喝
drinks	饮料
drive	驾驶
Drive	驾驶
driven	驱动
driver	司机
drivers	司机
drives	驱动器
drivin	驱车
driving	主动
drop	下降
Drop	下降
dropped	下降
dropping	落下
drops	滴剂
Drops	滴剂
drove	开车
drowning	溺死
drug	药物
drugstore	药店
drum	鼓
Drum	鼓
drunk	醉
DRUNKEN	醉
dry	干
dryer	烘干机
dryers	机
drying	烘干
du	杜
duck	鸭
Duck	鸭
ducks	鸭子
Ducks	鸭子
duct	管
dud	无用的人
dude	花花公子
Dude	多德
dudes	帅哥
Dudes	花花公子
Dudley	达德利
due	应有
dues	税
dug	挖
Dug	挖
duh	咄
Duh	咄
dull	平淡
dum	达姆
dumb	哑
Dumb	哑
DUMB	哑
dumber	笨
dump	倾倒
dumped	甩
dumping	倾销
dumpster	垃圾箱
dun	逼债
Dun	逼债
Duncan	邓肯
dung	粪
duplex	双工
during	中
During	中
dust	灰尘
dustpan	簸箕
Dutch	荷兰人
dwarfed	所绘
dwarves	矮人
d'yaD'	雅
D'yaD'	雅
dying	垂死
Dyke	堤防
Dylan	迪伦
dynamic	动态
d'youD'	你
D'youD'	你
dysfunctional	功能失调
Dysprosium	镝
e	Ë
E	Ë
each	每
Each	每
eager	急于
ear	耳
Earl	伯爵
earlier	前
earlobes	耳垂
early	早
earn	赚
earned	赚
earpieces	耳塞
earring	耳环
earrings	耳环
ears	耳朵
earth	地球
Earth	地球
earthly	俗世的
ease	缓解
easier	更轻松
easiest	最简单的
easily	容易
easing	缓解
east	东
East	东
Easter	复活节
Eastwood	伊斯特伍德
easy	简单
Easy	简单
eat	吃
Eat	吃
eaten	吃过
eater	吃
eating	吃
eats	吃
eavesdropping	窃听
Eavesdropping	窃听
ebola	埃博拉病毒
Ebony	乌木
eclipse	日食
economics	经济学
ecstatic	欣喜若狂
ectomy	切除
Ed	埃德
Eddie	埃迪
edge	边缘
edgy	前卫
edition	版
Edna	埃德娜
Eeh	英皇酒店
effect	影响
Effective	有效
efficiently	有效率的
effort	功夫
egg	蛋
Egg	蛋
Eggert	埃盖特
eggplant	茄子
Eggroll	蛋卷
eggs	蛋
Eggs	蛋
eggshell	蛋壳
eh	啊
Eh	啊
eight	八
Eight	八
eighteen	十八
either	或
Either	或
el	埃尔
elaborate	阐述
Elaine	伊莱恩
elastic	弹
elbow	弯头
elbows	肘部
electric	电动
Electrical	电动
electrician	电工
electricity	电力
Electrifying	通电
electromagnetic	电磁
elegant	优雅
element	元件
elevator	电梯
eleven	十一
Eleven	十一
elf	小精灵
eligible	合格
Eligible	合格
eliminated	淘汰
Elizabeth	伊丽莎白
ell	埃尔
Elle	艾丽
eloping	私奔
else	其他
Elton	埃尔顿
elves	精灵
embarassing	尴尬
embargo	禁运
embarrass	阻碍
embarrassed	尴尬
embarrassing	尴尬
embassy	大使馆
emblem	徽
embolism	栓塞
embryo	胎
embryos	胚胎
emerald	翠
emergencies	紧急情况
emergency	急
Emergency	急
Emil	埃米尔
Emily	艾米莉
Emma	艾玛
emotion	情感
emotional	情绪化
Emotional	情绪化
emotionally	感情上
emotions	情绪
emphatic	语调强的
Emphatic	语调强的
emphysema	气肿
Empire	帝国
employee	雇员
empowered	授权
emptied	清空
emptier	空虚
empty	空
Empty	空
en	恩
encircles	环绕
enclosed	封闭
encourage	鼓励
encyclopedias	百科全书
end	结束
END	结束
endearing	优胜
Endearment	母女情深
ended	结束
ending	结尾
endless	无穷
endometria	子宫内膜
ends	结束
enema	灌肠剂
enemas	灌肠
energetic	有活力
energized	通电
energy	能源
engaged	订婚
engagement	订婚
engine	发动机
England	英国
English	英语
engorged	充血
engraved	刻
enigma	谜
enjoy	请享用
Enjoy	请享用
enjoyed	享受
enjoying	享受
enormous	巨大
Enormous	巨大
enough	足够
Enough	足够
ensemble	合奏
entail	意味着
enter	输入
entered	进入
entering	进入
Enterprise	企业
entertainment	娱乐
Entertainment	娱乐
enthused	热情
enthusiasm	热情
entire	整个
entirely	完全
entrance	入口
entry	条目
envelope	信封
Envelope	信封
environment	环境
environmental	环境的
envy	羡慕
epic	史诗
Epic	史诗
episode	插曲
episodes	发作
equally	相等
equals	等于
equator	赤道
equipment	设备
er	呃
Er	尔
era	时代
erase	抹去
erased	擦除
eraser	橡皮
erasing	擦除
erect	直立
Eric	埃里克
Erica	埃里卡
Ernest	欧内斯特
Ernie	厄尼
erogenous	性感的
erotica	黄色书刊
err	呃
Err	呃
errands	跑腿
error	错误
ersonal	个人
Erwin	欧文
escalator	自动楼梯
escape	逃逸
especially	特别
Especially	特别
espresso	浓咖啡
essence	本质
est	美东时间
established	既定
estate	房地产
Estefan	斯特芬
Estelle	埃斯特尔
Esther	以斯帖
Estimated	预计
Estrada	埃斯特拉达
eternity	永恒
Ethan	阮经天
ether	醚
ethnic	民族
euphemisms	委婉语
Euphoria	欣快症
Europe	欧洲
European	欧洲的
Eva	伊娃
Eve	前夕
Evelyn	伊夫林
even	甚至
Even	甚至
evening	晚间
event	事件
eventhough	即使
eventually	终于
Eventually	终于
ever	曾经
Ever	自从
everbody	每个人
Everbody	每个人
Everest	珠峰
everlasting	永恒的
every	一切
Every	一切
everybody	每个人
Everybody	每个人
everyday	每天
Everyday	每天
everyone	大家
Everyone	大家
everything	一切
Everything	一切
everythings	万物
everyting	一切
everywhere	到处
evicted	被驱逐
evil	邪恶
Evil	邪恶
evolution	演化
Evolution	演化
evolving	进化
Ewing	尤因
ex	前
exact	精确
exactly	究竟
Exactly	究竟
example	例
excellent	优秀
Excellent	优秀
except	除了
Except	除了
excepted	除外
exception	例外
exceptionally	异常
excessive	过多
Excessive	过多
exchange	交换
exchanged	交换
exchanges	交流
excited	兴奋
exciting	扣人心弦
exclamation	感叹
exclusive	独家
excuse	借口
Excuse	借口
excuses	借口
execute	执行
exellent	方位
Exellent	方位
exercise	行使
exercises	演习
exert	发挥
exhaling	呼气
exhausted	累
exictement	激动
exist	存在
exit	出口
exited	退出
exotic	异国情调
expand	扩大
expect	期望
expected	预期
expecting	期待
expects	预计
expense	费用
expenses	花费
expensive	昂贵
experience	经验
experiment	实验
experiments	实验
expert	专家
expertise	专门知识
expired	过期
expires	到期
explain	说明
explained	解释
explains	说明
explanation	说明
explode	爆炸
exploded	爆炸
explodes	爆炸
exposed	裸露
express	表达
Express	表达
expression	表达
expressway	高速公路
Extapa	伊斯塔帕
extended	扩展
Extension	扩展
extent	程度
exterior	外观
extinct	绝种
extra	额外
extravaganza	大汇演
Exxon	埃克森
eye	眼睛
eyeballs	眼球
eyebrow	眉
eyebrows	眉毛
eyed	独眼
eyelashes	睫毛
eyes	眼睛
Eyes	眼睛
eyesore	丑陋
eys	余仁生
fabric	布
fabrics	面料
fabulous	极好
Fabulous	极好
face	面对
Face	面对
faces	面孔
facing	面对
fact	事实
Fact	事实
factor	因子
factory	厂
Factory	厂
facts	事实
faculty	学院
faded	褪色
faeces	大便
fail	失败
failed	失败
failure	失败
failures	故障
faint	晕
fair	公平
Fair	公平
fairly	相当
fairness	公平
fairyland	仙境
faith	信仰
fake	假
faking	伪造
Faking	伪造
fall	秋季
fallen	堕落
fallic	阳具
fallin	坠落
falling	落下
falls	下降
false	假
Fame	名誉
familiar	熟
families	家庭
family	家庭
Family	家庭
famished	馁
famous	著名
fan	风扇
Fan	风扇
fancier	空想家
fancy	幻想
Fancy	幻想
fanny	舳
fans	球迷
fantasies	幻想
fantastic	奇妙
Fantastic	奇妙
fantastically	飞驰
fantasy	幻想
far	远
Farber	法伯
fare	票价
fares	票价
farm	农场
Farm	农场
farmer	农民
fart	放屁
fascinated	入迷
fascinating	迷人
fashion	时尚
fashioning	塑造
Fashions	时装
fast	快速
Fast	快速
Fasten	系
faster	快点
fastforward	快进
fat	脂肪
Fat	脂肪
father	父亲
Father	父亲
fatherhood	父亲
fatigues	迷彩服
fattest	最胖
fault	故障
favor	偏爱
favorite	喜爱
favour	偏爱
favourite	喜爱
favours	好处
fax	传真
fear	恐惧
feared	害怕
Fears	恐惧
feast	盛宴
feather	羽毛
feathers	羽毛
feature	特征
Feburary	二月
Federal	联邦
feeding	馈送
feel	感觉
Feel	感觉
feelin	感觉
feeling	感觉
feelings	情怀
feels	感觉
Feels	感觉
feet	脚
Felicity	祺
fell	下跌
fella	小伙子
fellas	小伙子们
Fellas	盗亦有道
fellow	同伴
fellows	研究员
felon	重犯
felt	毡
female	女
females	女性
feminist	女权主义者
Feminist	女性主义
Fergie	弗格森
ferrets	雪貂
ferry	渡船
Ferry	渡船
fertile	沃
fertility	生育能力
fest	巨星
festive	欢乐的
Fetch	取
fetus	胎儿
few	少数
fewer	少
fiance	未婚夫
fiasco	惨败
fiches	销售商
fiction	小说
fictional	虚构
fictitious	虚拟
Fiddler	提琴手
fiddling	摆弄
field	领域
Fields	字段
fifteen	十五
Fifteen	十五
fifteenth	第十五
fifth	第五
Fifth	第五
fifties	五十年代
fifty	五十
fight	斗争
Fight	斗争
fighter	战斗机
fighting	战斗
Fighting	战斗
fights	打架
figure	数字
figured	想通
Figured	想通
figures	数据
figuring	盘算
file	文件
filet	内圆角
filing	备案
Filing	备案
fill	填
Fill	填
filled	填充
filling	填充
fills	填充
film	电影
filming	拍戏
filter	过滤
filters	过滤器
filth	污垢
final	最后
finally	最后
Finally	最后
finances	财政
Financial	金融
financially	经济
find	找
Find	找
Finders	发现者
finding	发现
findings	发现
finds	认定
fine	精细
Fine	精细
FINE	精细
finer	细
finest	最好的
finger	手指
Finger	手指
fingernail	指甲
fingernails	指甲
fingers	手指
fini	菲尼
finish	完
Finish	完
finished	完
finishing	精加工
Finkel	芬克尔
Fir	冷杉
fire	火
Fire	火
fired	解雇
Fired	被解雇
fireman	消防队员
firemen	消防员
fires	火灾
fireworks	烟花
firm	公司
first	第一
First	第一
fish	鱼
fished	捕鱼
Fisher	费舍尔
fishhook	鱼钩
fishing	钓鱼
fishnet	鱼网
fishtank	鱼缸
fist	拳头
fit	适合
fits	适合
fitting	配件
five	五
Five	五
fix	固定
fixable	可以解决
fixating	行了吧
fixed	固定
fixing	定影
flabby	松弛
flag	旗
Flag	旗
flail	连枷
flame	火焰
Flame	火焰
flames	火焰
flan	水果馅饼
Flan	水果馅饼
flash	闪
flashback	倒叙
Flashdance	劲舞
flashing	闪烁
flashy	华而不实
flask	烧瓶
flat	平面
Flatley	弗拉特利
flatness	平整度
flattering	谄媚的
flattery	阿谀
flavor	味道
flavors	口味
flavoured	有味
flaw	缺陷
flaws	破绽
fleas	跳蚤
Fledermaus	蝙蝠
fleet	舰队
Fleischman	弗莱施曼
flesh	肉
flew	飞
flick	拂去
flicked	轻弹
flicking	轻拂
flies	苍蝇
flight	飞行
Flight	飞行
fling	一扔
Flintstones	摩登原始人
flip	翻动
Flip	翻动
flipped	翻转
Flipper	翻转
flipping	翻转
flirt	调情
flirtin	勾引
flirting	调情
flitted	掠过
flitting	飞来飞去
floating	漂浮的
flock	群
flood	洪水
floor	地板
floors	地板
flop	拍击声
flopping	假摔
Florence	佛罗伦萨
Florida	佛罗里达
florist	花商
floss	绵
flossing	使用牙线
flour	面粉
flower	花
flowers	花卉
Flowers	花卉
flowing	流动
Floyd	弗洛伊德
fluff	起毛
fluffed	拍过
fluffy	蓬松
Fluffy	蓬松
fluid	流体
flung	甩到
fluorescent	荧
flush	红晕
flushes	刷新
fly	飞
flyers	传单
flying	飞行
foam	泡沫
focus	焦点
focused	重点
focusing	调焦
fog	多雾路段
foghorn	雾号
Foghorn	雾号
foil	挫败
fold	折
Fold	折
folded	折叠
folders	文件夹
folding	折页
folks	乡亲
Folks	乡亲
follow	跟随
followed	其次
following	以下
follows	如下
font	字形
fonts	字体
food	餐饮
Food	餐饮
foods	食品
Foods	食品
fool	傻子
fooled	上当
foolin	愚弄
fooling	嘴硬
fools	傻瓜
foosball	桌上足球
foot	脚丫子
Foot	脚丫子
football	足球
Footloose	浑身是劲
foots	脚灯
for	对于
For	对于
forbid	禁止
forbidden	被禁止
force	力
forced	被迫
Ford	涉
forearm	前臂
forefathers	祖先
foreign	国外
foreigners	外国人
Forensics	取证
forest	森林
forever	永远
Forever	永远
forget	忘记
Forget	忘记
forgetting	遗忘
forgive	原谅
forgiven	原谅
forgiving	宽容
forgot	忘记
Forgot	忘记
fork	叉子
Fork	叉子
form	形成
formality	礼节
formation	编队
formerly	以前
forms	形式
forth	向前
Fortunata	福尔图纳塔
fortunately	幸好
Fortunately	幸好
fortune	幸运
Fortune	幸运
forty	四十
Forty	四十
forward	向前
fossils	化石
Foster	培育
foul	犯规
found	发现
Found	发现
founder	创办人
fountains	喷泉
four	四
Four	四
fours	四肢
fourteen	十四
fourth	第四
Fourth	第四
Fowl	鸡
fox	狐狸
Foxtrot	狐步舞
Foxy	狡
fracture	断裂
Fraid	冒牌货
frame	帧
frames	帧
Fran	弗兰
France	法国
Francesca	弗朗西斯
Francis	弗朗西斯
Francisco	弗朗西斯科
Frank	坦率
Frankie	弗兰基
frankly	坦白说
franks	弗兰克斯
Franks	弗兰克斯
fraud	骗局
freak	怪物
freaked	吓坏
freaking	再用
freakish	滑稽可笑的
Freakish	滑稽可笑的
freaks	怪胎
freaky	辣妈
Freaky	辣妈
freckle	雀斑
Freddie	房地美
free	自由
Free	自由
FREE	自由
freebie	赠品
freedom	自由
Freedom	自由
Freemont	弗里蒙特
freeze	冻结
freezer	冰箱
freezing	冷冻
French	法国
frenzy	发狂
Fresca	弗雷斯卡
fresh	新鲜
Fresh	新鲜
freshen	梳洗
freshly	新鲜
freshman	新生
Freud	弗洛伊德
Freudian	弗洛伊德
Friday	星期五
fridge	冰箱
friend	朋友
friEnd	朋友
friendly	友好
friends	朋友
Friends	友
friendship	友谊
fries	薯条
Fries	薯条
frieze	带状装饰
frigerate	冰箱上
fright	惊骇
frightening	可怕的
frisbee	飞盘
frolicking	嬉戏
from	从
From	从
front	面前
Front	面前
frontier	边境
frost	霜
frozen	冻结的
Frozen	冻结的
fruit	水果
Fruit	水果
fruitflies	果蝇
Fruitflies	果蝇
fruits	水果
frustrating	泄气
frying	油炸
fu	福
fuchsia	紫红色
fudge	做傻事
fuel	汽油
fuels	燃料
fulfil	履行
fulfilled	完成
fulfilling	履行
full	充分
Full	充分
fully	充分
Fumble	摸索
fumes	油烟
fun	开玩笑
Fun	开玩笑
fundamentally	从根本上
funeral	葬礼
Funeral	葬礼
Funk	恐惧
funky	时髦
funniest	最有趣
Funniest	最有趣
funnily	好笑
funny	滑稽
Funny	滑稽
fur	毛皮
furnishings	家具
furniture	家具
furry	毛茸茸
further	进一步
fuse	保险丝
futile	徒劳的
futon	蒲团
future	未来
fuzzy	模糊
Fuzzy	模糊
Gaelic	盖尔语
gag	呕吐
gagging	矫正
Gail	盖尔
gain	获得
gaining	获得
gains	收益
gal	加
galaxy	星系
gallivanting	闲逛
gallon	每加仑
gals	姑娘们
game	游戏
Game	游戏
games	游戏
Games	游戏
Gandolf	甘道夫
gang	帮派
Gang	帮派
ganged	同轴
Ganja	大麻
garage	车库
garbage	垃圾
Garden	花园
Gary	加里
gas	气体
gassy	瓦斯
gate	门
gather	收集
gathered	聚集
gathering	收集
gave	给了
Gawd	上帝
GAWD	上帝
gawk	腼腆的人
gay	同性恋
Gay	同性恋
gazebo	露台
gazillion	无数
gear	齿轮
gee	哇
Gee	哇
geek	极客
geeky	极客
Geena	吉娜
geese	鹅
Geez	天啊
Gehrig	伽
geisha	艺妓
gel	凝胶
Geller	盖勒
Gellers	盖勒
Gene	基因
general	一般
General	一般
generally	一般
generation	一代
generations	一代又一代
generous	慷慨的
genetically	基因
genitalia	生殖器
genius	天才
genre	那种
gentle	温柔的
gentleman	绅士
Gentleman	绅士
gentlemen	先生们
Gentlemen	先生们
gentler	温和的
genuine	真正的
genuinely	真正的
geography	地理位置
Geometry	几何
George	乔治
German	德国
Germans	德国人
germs	细菌
Gershwin	格什温
gesture	手势
gesturing	手势
get	得到
Get	得到
GET	得到
gets	得到
Gets	得到
gettin	捞到
Gettin	捞到
getting	得到
Getting	得到
ghost	鬼
Ghost	鬼
ghosts	鬼魂
giant	巨大的
Giant	巨大的
Giants	巨人
Gibson	吉布森
giddy	头晕
gift	礼物
Gift	礼物
gifts	礼物
gig	演出
gigantic	巨大的
giggly	傻笑的
gills	鳃
gin	杜松子酒
Gin	杜松子酒
ginger	姜
Ginger	姜
giorno	义大利
Giorno	义大利
giraffe	长颈鹿
girl	女孩
Girl	女孩
GIRL	女孩
girlfriend	的女朋友
girlfriends	女朋友
girlie	少女
girls	女孩
Girls	女孩
girly	女孩
girth	周长
Girth	周长
gist	要点
give	给
Give	给
GIVE	给
given	鉴于
giver	给予者
gives	给了
giving	给
glacier	冰川
glad	很高兴
Glad	很高兴
glance	看
glands	腺
glass	玻璃
Glass	玻璃
glasses	眼镜
glazed	上釉
glazing	玻璃
Glen	格伦
glitter	闪闪发光的
globe	全球
Glocken	钟声
Gloria	格洛丽亚
glove	手套
gloves	手套
Gloves	手套
glow	发光
Glow	发光
glue	胶水
glued	粘
g'nightg	夜间
G'nightG	夜间
go	去
Go	去
GO	去
goalie	守门员
goals	目标
goat	山羊
Goat	山羊
goatee	山羊胡子
goats	山羊
god	神
God	神
GOD	上帝
goddess	女神
goddesses	女神
Goddesses	女神
gods	神
Gods	神
goes	去
goggles	护目镜
Gogh	梵高
goin	戈因
Goin	戈因
going	会
Going	会
gold	黄金
Gold	黄金
golden	金
goldfish	金鱼
Goldie	戈尔迪
Goldman	高盛
golf	高尔夫球
golfing	打高尔夫球
gon	百分度
GON	百分度
gone	走了
Gone	走了
gonna	要
goo	咕
Goo	咕
goober	花生
good	好
Good	好
goodbye	再见
Goodbye	再见
Goodfella	收购价格
goodness	善
goodnight	晚安
Goodnight	晚安
goods	货物
goofing	——塞
goofy	高飞
gook	人的蔑称
goon	怪诞的人
goood	很好的
GOOOD	很好的
gooooood	的效果
goop	黏糊糊的东西
goose	鹅
gorgeous	华丽的
gosh	天啊
Gosh	天啊
got	得到了
Got	得到了
gotcha	问题
Gotcha	问题
gotten	得到
gouged	挖
gouging	刨
government	政府
governor	州长
grab	抓住
Grab	抓住
grabbed	抓住了
grabbing	抓住
grabs	抓住
grace	恩典
grad	研究生
grade	年级
graduated	毕业
graduating	毕业
graduation	毕业
Graduation	毕业
graduations	毕业典礼
graft	贪污
gram	克
Gram	克
grand	伟大的
grandchildren	孙子
GRANDCHILDREN	孙子
granddaughter	的孙女
grandfather	祖父
Grandfather	祖父
grandkids	孙子
grandma	奶奶
Grandma	奶奶
grandmother	祖母
Grandmother	祖母
grandpa	爷爷
Grandpa	爷爷
grandparents	爷爷奶奶
grandson	孙子
grant	格兰特
Grant	格兰特
granted	授予
grape	葡萄
Grape	葡萄
grapes	葡萄
grappa	格拉巴酒
Gras	胖
Grasp	掌握
grass	草
grave	坟墓
gravel	砾石
graveyard	墓地
gravity	重力
gravy	肉汁
gray	灰色的
grazed	擦伤了
Grazie	谢谢
grease	油脂
Grease	油脂
greasy	油腻的
great	伟大的
Great	伟大的
greatest	最大的
greatful	感激
greatness	伟大
Greek	希腊
green	绿色
Green	绿色
Greene	格林
Greenpeace	绿色和平组织
Greenstein	格林斯坦
greet	问候
greeter	迎宾
greeting	问候
Gremlin	小鬼
grew	增长
grey	灰色
Grey	灰色
grief	悲伤
Grievances	不满
grieve	悲伤
grill	烧烤
grilled	烤
Grinch	令人扫兴的人
grinds	磨
grip	控制
groceries	食品杂货
grocery	杂货店
groin	腹股沟
groom	新郎
grooming	梳理
groovin	很棒
grope	摸索
groping	摸索
gross	总值
Gross	总值
grossly	严重
grotesque	怪诞
grotesquely	奇异地
ground	地面
groundwork	奠定基础
group	集团
grow	成长
Grow	成长
growing	日益增长的
grown	种植
grownup	成人
grows	生长
grrreat	真是棒极了
grumpy	脾气暴躁的
guacamole	鳄梨色拉酱
guaranteed	保证
guarantees	担保
guard	警卫
guava	番石榴
guess	猜一猜
Guess	猜一猜
guesses	猜测
guessing	猜测
guest	客人
Guest	客人
guests	客人
Guggenheim	古根海姆
Guggly	水流的潺潺声
guidance	指导
guide	指南
Guide	指南
guides	指南
guilt	内疚
guilty	有罪
guitar	吉他
gum	口香糖
Gum	口香糖
gumball	口香糖
Gummi	树胶
gums	牙龈
gun	枪
gunman	枪手
gunpoint	枪口
guns	枪支
Gunther	冈瑟
gurney	格尼
guru	大师
Guru	大师
gut	肠道
gutless	没勇气的
guts	勇气
gutter	地沟
guy	的家伙
Guy	家伙
guys	人
Guys	人
gym	健身房
GYN	妇科
gynaecologist	妇科医生
had	有
Had	有
hah	哈
Hah	哈
haha	哈哈
hair	头发
haircut	发型
haircuts	理发
hairdo	发型
hairier	很多毛
hairline	发际线
hairpiece	假发
hairy	多毛的
half	一半
Half	一半
halftime	中场休息
Halftime	中场休息
hall	大厅
Hall	大厅
Halle	哈雷
Halloween	万圣节
hallway	走廊
ham	火腿
Ham	火腿
hamburger	汉堡
Hamburger	汉堡
hamburgers	汉堡包
Hamilton	汉密尔顿
Hammel	哈梅尔
hammer	锤
hammered	锤
hammerhead	锤头
hammock	吊床
hamper	阻碍
hamster	仓鼠
hand	手
Hand	手
handbag	手提包
handcuffs	手铐
handed	递给
handing	将
Handkerchief	手帕
handle	处理
handles	处理
handling	处理
Handling	处理
hands	手
Hands	手
handsome	英俊的
handy	方便的
hang	挂
Hang	挂
hanger	悬挂器
hangers	衣架
hangin	玩
hanging	挂
hangs	挂起
Hangs	挂起
Hans	汉斯
Hanukkah	光明节
haphazard	偶然的
happ	没说完
happen	发生
happened	发生了
happening	发生
Happening	发生
happens	发生
happier	快乐
happiest	最快乐的
happily	幸福的
happiness	幸福
happy	快乐
Happy	快乐
hard	硬
Hard	硬
hardball	硬式棒球
hardcore	硬核
harder	困难
hardest	最严重的
hardly	几乎没有
Hardly	几乎没有
hardware	硬件
Hardwood	硬木
Hardy	哈代
Harmon	哈蒙
harmonica	口琴
Harmonica	口琴
Harry	哈利
harsh	严厉的
has	有
Has	有
Hassidic	哈西德派的
hasty	匆忙的
hat	帽子
Hat	帽子
hate	讨厌
Hate	讨厌
hated	讨厌
hates	讨厌
hating	讨厌
Hating	讨厌
hats	帽子
hauling	搬运
Hauser	豪泽
have	有
Have	有
HAVE	有
havent	没
havin	每天
having	有
Having	有
Hawaii	夏威夷
hazel	黑兹尔
he	他
He	他
head	头
Head	头
HEAD	头
headache	头痛
headboard	床头板
headed	领导
headin	该
heading	标题
heads	头
Heads	头
headsets	耳机
headway	进展
health	健康
healthy	健康的
hear	听到
Hear	听到
heard	听到
Heard	听到
hearing	听力
heart	心
Heart	心
heartbeat	心跳
heartbeats	心跳
hearts	心
heat	热
Heat	热
heather	希瑟
heating	加热
Heating	加热
heave	胀
heaven	天堂
heaving	起伏
heavy	重
Heavy	重
heck	真见鬼
Heckles	的抨击
hedges	篱笆
heel	跟
heeled	倾斜
heels	高跟鞋
heh	哈
Heh	哈
Heidi	海蒂
height	高度
heightened	加剧了
heights	高度
Heights	高度
heinie	屁股
hel	冥界
Hel	冥界
held	举行
Helen	海伦
helicopter	直升机
helicopters	直升机
hell	地狱
Hell	地狱
hello	你好
Hello	你好
help	帮助
Help	帮助
helped	帮助
helper	助手
helpers	助手
helpful	有帮助的
helping	帮助
helps	帮助
Helps	帮助
Hemorrhoids	痔疮
Hemp	麻
Henderson	亨德森
Henry	亨利
her	她的
Her	她的
herbal	草药
herd	群
here	在这里
Here	在这里
Hermit	隐士
hernia	疝
hero	英雄
hers	她的
herself	自己
hes	他
Heston	赫斯顿
heterosexual	异性恋
Hewitt	翰威特
hey	嘿
Hey	嘿
HEY	嘿
hi	嗨
Hi	嗨
hiccups	打嗝
hickey	希基
hidden	隐藏的
hide	隐藏
Hide	隐藏
hideous	可怕的
hideously	出奇的
hiders	隐藏者
hiding	隐藏
high	高
High	高
higher	更高的
highest	最高
highly	高度
highness	殿下
highway	高速公路
hike	徒步旅行
Hike	徒步旅行
hiker	徒步旅行者
hilarious	非常滑稽的
hills	山
him	他
Him	他
HIM	他
himself	自己
hint	提示
hip	臀部
hire	雇佣
hired	聘请了
hires	员工
hiring	招聘
his	他的
His	他的
hissy	一阵
history	历史
History	历史
hit	打击
hitch	结
hits	支安打
hitting	打
Hm	嗯
hmm	嗯
Hmm	嗯
Hmph	嗯
ho	何
Ho	何
Hobbit	霍比特人
hobby	爱好
hockey	曲棍球
Hockey	曲棍球
hoggin	粗砂
hogging	占用
hold	持有
Hold	持有
Holden	霍尔顿
holding	持有
HOLDING	持有
hole	洞
holes	孔
holiday	假期
Holiday	假期
holidays	假期
Holland	荷兰
holocaust	大屠杀
holy	神圣的
home	家
Home	家
homecoming	同学会
homemade	自制的
homerun	全垒打
homes	房屋
homesick	想家
Homo	人类
homosexual	同性恋
homosexually	性渠道
hon	亲爱的
Hon	亲爱的
honest	诚实的
honestly	诚实
honesty	诚实
Honesty	诚实
honey	蜂蜜
Honey	蜂蜜
honeymoon	度蜜月
honing	珩磨
honk	按汽车喇叭
honor	荣誉
Honor	荣誉
honorary	荣誉
honored	很荣幸
honour	荣誉
honoured	荣幸
hoo	呼!
Hoo	呼!
hood	罩
hooing	何
hook	钩
Hook	钩
hooked	钩状的
hooker	妓女
hooking	连接
hooo	哈哈
hoop	呼啦圈
hoopla	喧闹
hop	跳
hope	希望
Hope	希望
hoped	希望
hopefully	希望
Hopefully	希望
hopeless	绝望的
hopes	希望
hoping	希望
hopped	跳
hopping	跳来跳去
hormones	激素
Hormones	激素
horns	角
horny	角质
horoscope	星座
horrible	可怕的
Horrible	可怕的
horribly	可怕的
horseback	马背上的
horses	马
Horton	霍顿
Hoshi	法师
hospital	医院
Hospital	医院
hostages	人质
hostess	女主人
hot	热
Hot	热
hotel	酒店
hottest	最热的
hound	猎犬
hour	小时
hours	小时
house	房子
House	房子
housekeeper	管家
houses	房子
housetrained	管教
housewares	家用器皿
hovercrafts	气垫船
hovering	徘徊
how	如何
How	如何
Howard	霍华德
Howdy	你好
however	然而
However	然而
hows	豪视安科公司
Hoyt	霍伊特
huddle	挤作一团
Huddle	挤作一团
Huey	休伊
hug	拥抱
Hug	拥抱
huge	巨大的
hugging	拥抱
Hugh	休
Hugo	雨果
hugs	拥抱
huh	哈
Huh	哈
hula	草裙舞
Hulk	绿巨人
hum	嗡嗡声
human	人类
Human	人类
HUMAN	人类
humanity	人类
humans	人类
humidity	湿度
humiliated	羞辱
humiliating	羞辱性的
Humm	嗯
hummus	鹰嘴豆泥
Hummus	鹰嘴豆泥
humor	幽默
humour	幽默
hump	驼峰
humping	呈驼峰状
Humping	呈驼峰状
hundred	几百
hundreds	数百
hundredth	第一百位
hung	挂
hunger	饥饿
hungry	饿了
hunk	大块
hunt	亨特
Hunter	猎人
hurl	投
Hurley	赫尔利
hurry	快点
Hurry	快点
Hurs	户珥
hurt	伤害
Hurt	伤害
hurting	伤害
hurts	伤害了
husband	丈夫
hut	小屋
Hut	小屋
huts	小屋
hygiene	卫生
hygienist	保健师
hymn	赞美诗
hyphen	连字符
hypnosis	催眠
hypnotise	使进入催眠状态
hypnotised	催眠
hypothetically	假设
hysterical	歇斯底里的
i	我
I	我
ice	冰
Ice	冰
iced	冰
ick	难闻的
Ick	难闻的
icky	令人作呕的人
Icky	令人作呕的人
icy	冰冷的
idea	的想法
ideal	理想的
ideally	在理想的情况下
ideas	的想法
identical	相同的
identifies	标识
identify	识别
idiot	白痴
Idiot	白痴
IDIOT	白痴
idiots	白痴
if	如果
If	如果
igneous	火成岩
ignore	忽略
ignoring	忽略
Ihe	国内
II	二世
III	Ⅲ
Ikea	宜家
illegal	非法
illegally	非法
illusion	错觉
Illustrated	说明
Im	即时通讯
image	图像
Image	图像
images	图片
imaginary	虚构的
imagination	想象力
imagine	想象一下
Imagine	想象一下
imagined	想象
imagining	想象
imals	喊叫
immature	不成熟的
immigration	移民
immodest	不谦虚的
imp	小鬼
impaired	受损的
impartial	公正的
impending	即将到来的
Imperial	帝国
impish	顽皮的
implantation	植入
implanted	植入
implementing	实现
important	重要的
importantly	重要的是
impossible	不可能的
impress	留下深刻印象
impressed	深刻的印象
impression	印象
impressions	印象
impressive	令人印象深刻的
Impressive	令人印象深刻的
improper	不当
improvement	改进
impulse	冲动
in	在
In	在
IN	在
inadequate	不充分的
inappropriate	不合适的
Inappropriate	不合适的
inch	英寸
inches	英寸
inching	缓慢
incidence	影响
incident	事件
incidentally	顺便说一下
incisive	门齿的
incoming	传入的
incompetent	不称职的
inconvenience	带来的不便
incorporate	合并
incredible	这是一种不可思议的力量！
Incredible	这是一种不可思议的力量！
incredibly	令人难以置信的
Indecent	有伤风化的
Indeed	事实上
indeedy	不见得吧
independence	独立
Independence	独立
independent	独立的
index	指数
India	印度
indian	印度人
Indian	印度人
Indians	印度人
indicated	指示
inedible	不可食用
infected	感染
infection	感染
infectious	传染病
inflatable	充气
inflate	膨胀
inflated	充气
inflict	造成
influence	影响
info	信息
information	信息
Information	信息
INFORMATION	信息
informative	信息
informed	通知
ingredients	配料
Ingrid	英格丽
initial	初始
initials	声母
initiate	发起
injection	注射
injure	损伤
ink	墨
inlcuding	包含
innate	先天
inner	内
innocent	无辜
innocently	傻傻
Innsbruck	因斯布鲁克
input	输入
inputting	输入
inquiry	查询
insane	疯
Insane	疯
insanely	疯狂地
inseam	裆
insects	昆虫
insecure	不安全
insensitive	麻木不仁
inside	内
insider	内幕
insignificant	微不足道
insist	咬定
insisted	坚持
insisting	坚持
insoles	鞋垫
inspect	检查
inspiration	灵感
Inspiration	灵感
inspire	启发
inspired	启发
instance	例
instead	代替
Instead	代替
instincts	本能
Institute	研究所
instructor	讲师
instrument	仪器
insulation	绝缘
insult	侮辱
insulted	受辱
insulting	侮辱
insurance	保险
Insurance	保险
intellectual	知识分子
intelligence	情报
intelligent	智能
intense	激烈
Intense	激烈
intent	意图
interactive	互动
interchangeable	通用
interest	利益
interested	有兴趣
interesting	有趣
Interesting	有趣
interestingly	有趣
interests	利益
interiors	内饰
Interiors	室内设计
intermission	幕间休息
international	国际
internet	互联网
interrupt	打断
interrupted	间断
Interstate	州际
interview	访问
interviewed	采访
interviewing	面试
interviews	面试
intestine	肠
intimacy	亲密关系
intimate	亲密
intimated	暗示
intimdating	吓人
intimidated	吓倒
into	成
Into	成
intrigued	好奇
introduce	介绍
introduced	介绍
introducing	引入
intuitive	直观的
invade	入侵
invented	发明
inventor	发明者
invested	投资
invisible	无形
Invisible	无形
invitation	请帖
invitations	邀请函
invite	邀请
Invite	邀请
invited	邀请
inviting	诱人的
invoice	发票
involve	涉及
involved	参与
involves	涉及
IQ	智商
Iran	伊朗
Iris	鸢尾花
Irish	爱尔兰的
iron	铁
ironic	具有讽刺意味
Ironically	讽刺地
irony	讽刺
irreplaceable	不可替代
irresponsible	不负责任
is	是
Is	是
Isaac	艾萨克
Isabella	伊莎贝拉
island	岛
Island	岛
isnt	心不是
Israeli	以色列
Issac	伊萨克
issue	问题
issues	问题
it	它
It	它
IT	它
Italian	意大利
Italy	意大利
itching	瘙痒
itchy	发痒的
item	项目
items	项目
Ithica	伊萨卡
itinerary	行程
its	它的
Its	它的
itself	本身
it'snot	不是
Ive	我有
Ivory	象牙
ized	化的
Jabba	贾巴
jack	插口
Jack	插口
jacket	夹克
Jacket	夹克
jackets	夹克
jacks	千斤顶
Jade	玉
Jag	乱切
Jaguar	捷豹
jail	监狱
Jail	监狱
Jake	可靠的人
jam	果酱
Jam	果酱
James	詹姆士
Jamestown	詹姆斯敦
Jamie	杰米
jammed	卡住
jammer	干扰
jammies	睡衣
jamming	拥塞
jams	果酱
Jan	一月
Jane	简
Janice	贾尼斯
January	一月
Japan	日本
Japanese	日本
jar	罐
Jared	贾里德
jars	罐子
Jasmine	茉莉花
Jason	贾森
jaunty	轻松活泼
Jaunty	贾蒂
JavaJava	的
jazz	爵士乐
jealous	妒
jealousy	妒忌
Jean	吉恩
Jeannie	珍妮
Jedi	绝地
Jeepers	车友
jeez	哎呀
Jeez	哎呀
Jell	果冻
jellies	果冻
jellyfish	海蜇
Jellyfish	海蜇
Jennifer	詹妮弗
jeopardise	危害
jeopardising	危害
Jeopardy	危险
jerk	混蛋
Jerk	混蛋
jerks	抽搐
jerky	生涩的
Jerry	杰瑞
jersey	球衣
Jessica	杰西卡
Jessy	杰西
Jester	滑稽演员
Jesus	耶稣
jet	喷射
Jetson	特森
jetway	捷波
Jew	犹
jewellers	珠宝商
jewelry	首饰
Jewish	犹太
Jill	吉尔
Jim	吉姆
JIMBO	神保
Jimmies	糖条
jimmy	吉米
Jimmy	吉米
jingle	叮铃
Jingle	叮铃
jingles	顺口溜
Jll	仲量联行
JLL	仲量联行
Jo	乔
Joan	琼
Joanna	乔安娜
Joanne	乔安妮
job	工作
jobs	工作
jock	乔克
jockstrap	护身三角绷带
Jody	乔迪
Joe	乔
Joel	乔尔
Joey	乔伊
jogs	慢跑
John	约翰
Johnny	约翰尼
Johnson	约翰逊
join	加入
joined	加盟
joint	联合
jointed	节理
joke	玩笑
Joker	滑稽角色
jokes	笑话
joking	开玩笑
jolly	欢乐
Jonny	强尼
Joseph	约瑟夫
Josephine	约瑟芬
Josh	玩笑
Joshua	约书亚
journal	日志
journalist	记者
Jovi	·乔维
joy	喜悦
joyous	欢乐
ju	菊
Ju	菊
Judas	犹大
judge	法官
Judge	法官
judged	判断
judgemental	评判
judging	判断
Judging	评审
judgment	判断
judgmental	评判
Judy	朱迪
juggler	变戏法
juggling	戏法
juice	果汁
Juice	果汁
juicy	多汁
juist	尤斯特
Jules	儒勒
Julia	朱莉娅
Julie	朱丽叶
Julio	胡里奥
July	七月
jump	跳
jumped	跳下
jumping	跳跃
Junction	连接点
June	六月
jungle	丛林
Jungle	丛林
junior	初级
Junior	初级
junk	破烂
Jurassic	侏罗纪
jus	强制
just	只是
Just	只是
justice	正义
justify	辩解
K	ķ
Kane	凯恩
Kaplan	卡普兰
Karaoke	卡拉
karate	空手道
Karen	卡伦
karma	因果报应
karmic	业力
Kate	凯特
Kath	凯丝
Katherine	凯瑟琳
Kathy	凯西
kay	凯
Kay	凯
ke	柯
keep	保持
Keep	保持
keeper	管理人
keepers	饲养员
keeping	保持
keeps	保持
Keeps	保持
keg	桶
Kelly	黄绿色
Ken	肯
Kennedy	肯尼迪
Kenny	肯尼
kept	不停
kerb	抑制
kettle	水壶
Kevin	凯文
key	键
keyboards	键盘
keyhole	锁孔
keys	按键
kibbles	粗粉
kick	踢
Kick	踢
kicked	踢
kickin	起作用
kicking	踢
kicks	踢
kid	孩子
kidder	基德
kiddie	小童
kiddin	开玩笑
kidding	开玩笑
Kidding	开玩笑
kiddo	老兄
Kidman	基德曼
kidnap	绑架
kidney	肾
KIDNEY	肾
kids	孩子
Kids	童装
Kiev	基辅
kill	杀
Kill	杀
killed	杀害
killers	杀手
killin	基林
killing	谋杀
Killing	杀
kills	杀死
Kim	金
Kims	金氏
kind	类
Kind	类
kinda	有点儿
Kinda	有点儿
kindergarten	幼儿园
Kindergarten	幼儿园
kinds	种
king	王
King	王
kingdom	王国
Kingdom	王国
Kip	基普
kiss	吻
Kiss	吻
kissed	吻
Kissed	吻
kisser	接吻
Kisser	接吻
kisses	吻
kissin	亲吻
kissing	接吻
kit	套件
kitchen	厨房
kite	风筝
kitten	小猫
kittens	小猫
kitty	猫咪
Kitty	猫咪
kiwi	猕猴桃
Kiwi	猕猴桃
klan	三
Kleenex	薄纸
Klein	克莱恩
Klien	克莱恩
knapsack	背包
knee	膝盖
kneed	用膝盖顶
knees	膝盖
knew	知道
Knick	尼克斯
knickers	短裤
Knicks	尼克斯
knife	刀
knight	骑士
Knight	骑士
Knights	骑士
knit	针织
Knit	针织
Knitting	针织
knives	刀
knob	把手
knock	敲
Knock	敲
knocked	被撞
knockout	昏死
knot	结
know	知道
Know	知道
KNOW	知道
knowing	会心
Knowing	会心
knowledge	知识
known	已知
knows	知道
knuckle	指关节
knuckles	关节
kook	疯子
Koon	冠
Korea	韩国
Korean	朝鲜的
Kostelic	科斯泰莉茨
Kristen	克里斯汀
Kristin	克里斯汀
Ku	苦
Kudos	荣誉
Kung	功夫
Kurt	库尔特
l	升
L	大号
L'L	”
la	啦
La	啦
lab	实验室
label	标签
labels	标签
labor	劳工
laboratory	实验室
labour	劳工
lace	花边
ladies	女士们
Ladies	女士们
Ladle	杓
lads	小伙子
lady	淑女
Lady	淑女
ladybug	瓢虫
ladybugs	瓢虫
lag	落后
laid	铺设
lake	湖
Lamaze	拉梅兹
lamb	羊肉
Lambchop	羊排
Lambert	兰伯特
lambs	羔羊
Lambs	羔羊
lame	瘸
laminated	层压
lamp	灯
Lamp	灯
lamps	灯具
land	土地
landed	登陆
landlord	房东
lands	土地
landscaping	美化
lane	车道
language	语言
languages	语言
lap	膝部
large	大
larger	大
larges	拉尔
Larry	拉里
Las	拉斯维加斯
lasagna	烤宽面条
lasagnas	烤宽面条
lasagne	千层面
laser	激光
Laser	激光
Lassie	恋人
last	持续
Last	持续
lasted	历时
lasts	持续
late	晚了
Late	晚了
lately	最近
later	后来
Later	后来
lather	泡沫
Lather	泡沫
lations	办法第十四
latte	拿铁
Lattes	拉特斯
Laude	以优异成绩
laugh	笑
laughable	可笑
laughed	笑了
laughin	嘲笑
laughing	笑
laughs	笑
laughter	笑声
laundry	洗衣店
Laurel	月桂树
Lauren	劳伦
Laurie	劳瑞
lava	岩浆
Laverne	拉维恩
law	法
lawfully	合法地
lawn	草坪
Lawrence	劳伦斯
lawyer	律师
lax	松
lay	铺设
layer	层
layering	分层
layin	储备
laying	铺设
lazy	懒
le	乐
lead	铅
leading	领导
leaf	叶
leafy	多叶
league	联盟
Leakey	利基
lean	靠
Lean	靠
leaned	凑近
leap	飞跃
learn	学习
Learn	学习
learned	学到了
learning	学习
Learning	学习
least	最小
leather	皮革
leave	离开
Leave	离开
leaves	树叶
leaving	离开
Lebanon	黎巴嫩
Lecter	莱克特
lecture	演讲
Lee	背风处
leeks	韭菜
left	剩下
Left	剩下
leftover	剩
leftovers	残羹剩饭
leg	腿
legal	法律
legend	传说
Leghorn	里窝那
legs	腿
Leia	累啊
Lem	莱姆
lemon	柠檬
Lemon	柠檬
lemonade	柠檬汽水
Lemonade	柠檬汽水
lend	借
Lender	贷款人
length	长度
Lenny	莱尼
lens	镜片
lenses	镜头
lent	借给
Leon	莱昂
Leonard	伦纳德
Leroy	乐华
lesbian	女同性恋
Lesbian	女同性恋
lesbianI	女同性恋
lesbianism	女同性恋
lesbians	女同志
lesiban	女同性恋
Leslie	莱斯利
less	减
Less	减
lesser	较小
lesson	课
Lesson	课
lessons	教训
let	让
Let	让
Lets	让我们
Let's	让我们
letter	信件
letterman	莱特曼
letters	信
letting	出租
lettuce	生菜
level	水平
levels	水平
Lewis	刘易斯
li	里
Liaisons	联络员
Liam	利亚姆
Liberace	利贝拉切
liberated	解放
liberty	自由
Liberty	自由
libraries	图书馆
library	图书馆
license	执照
lick	舔
Lick	舔
licked	舔
Licker	刺辊
lickers	刺辊
licking	舔
Licorice	甘草
lid	盖
lie	位于
lied	说谎
lies	谎
lieutenant	陆军中尉
life	生活
Life	生活
lifeboat	救生艇
lifeguards	救生员
Lifeguards	救生员
lifestyle	生活方式
lifetime	一生
lift	电梯
Lift	电梯
lifted	取消
lighning	闪电
light	光
Light	光
lighter	打火机
lighting	灯光
lightly	轻轻
lightning	闪电
Lightning	闪电
lightpost	灯杆
lights	灯火
Lights	灯火
like	喜欢
Like	喜欢
liked	喜欢
likely	容易
Likeness	像
likes	喜欢
Likewise	同样
liking	喜欢
lilly	礼来公司
lily	百合
Lily	百合
limb	肢
lime	酸橙
limerick	五行打油诗
limit	限制
Lincoln	林肯
Linda	琳达
line	线
lined	夹
linen	麻布
lines	线
lineup	排队
lingerie	女用贴身内衣裤
lingo	行话
lining	衬
lion	狮子
Lionel	莱昂内尔
lip	唇
lipper	涟漪
lips	嘴唇
Lips	嘴唇
Lipson	李碧菁
lipstick	口红
liquor	酒
liquorice	甘草
lire	里拉
Lisbon	里斯本
list	名单
listen	听
Listen	听
listening	听
listing	清单
lit	发光的
literally	按照字面
Literature	文献
litter	窝
littered	散落
little	小
Little	小
live	生活
lived	生活
liver	肝
livered	胆小的
lives	生活
Lives	生活
livin	活着
living	活的
Living	活的
Livingston	利文斯顿
Liza	丽莎
lizards	蜥蜴
Lizzie	丽兹
'll'	二
lo	罗
Lo	罗
load	加载
loaded	装
loaf	面包
loaned	贷款
loaner	借用
loathe	厌恶
lobster	龙虾
lobsters	龙虾
local	本地
lochs	湖泊
lock	锁
locked	锁定
locker	更衣室
locking	锁定
log	日志
logical	合乎逻辑
Lola	萝拉
lollipop	棒糖
London	伦敦
Londoners	伦敦
lone	孤单
lonely	孤独
long	长
Long	长
longer	长
longest	最长
longshot	远射
look	看
Look	看
looked	看着
lookin	顺便拜访
Lookin	顺便拜访
looking	看着
looks	容貌
Looks	容貌
loon	懒人
loong	龙
loop	环
loose	疏松
Loosely	松弛地
looters	乱兵
lopped	除名
Lord	主
lords	领主
Lori	洛瑞
Lorne	洛恩
Lorraine	洛林
Los	洛杉矶
lose	失去
Lose	失去
loser	失败者
Loser	失败者
losers	失败者
Losers	失败者
loses	失去
losin	会输
losing	失去
Losing	失去
loss	失利
lost	丢失
lot	批量
lotion	洗剂
lots	地段
Lots	地段
Lou	娄
loud	响
louder	响
loudly	高声
Louise	路易丝
lounge	休息室
lousy	糟糕
love	爱
Love	爱
loveable	可爱
loved	喜爱
Loved	喜爱
lovely	可爱
Lovely	可爱
lover	情人
Lover	情人
lovers	情侣
loves	爱
lovin	的爱
loving	爱心
low	低
Lowell	洛厄尔
lower	降低
loyal	忠诚
Lucille	露西尔
Lucite	璐彩特
luck	运气
luckiest	幸运
luckily	幸
Luckily	幸
lucky	幸运
Lucky	幸运
Ludwins	路金一家人
luggage	行李
lugging	拖着
Luisa	路易莎
luminous	发光的
lumps	硬块
lunar	太阴
lunch	午餐
lunchbox	午餐盒
lung	肺
lunges	弓步
lunging	冲刺
lycra	莱卡纤维
Lydia	莉迪亚
lyin	说谎
lying	说谎
lyme	莱姆
Lynch	林奇
Lysol	来苏
M	中号
ma	嘛
Ma	嘛
ma'am	夫人
Macaroni	通心粉
macaroon	马卡龙
Macaroons	杏仁饼
macaws	金刚鹦鹉
MacBeth	麦克白
MacDonald	麦克唐纳
mache	纸型
machine	机
Machine	机
MacPherson	麦弗逊式
Macy	梅西
mad	狂
Mad	狂
madcap	鲁莽
made	制作
Made	制作
Madge	马奇
Madison	麦迪逊
madly	发狂
madness	疯狂
MADNESS	疯狂
magazine	杂志
magazines	杂志
magic	魔法
Magic	魔法
magical	神奇
magically	神奇
magician	魔术师
Magician	魔术师
Magma	岩浆
magnet	磁铁
magnetic	磁性
magnets	磁铁
magnificent	华丽的
mah	麻将
Mahal	泰姬陵
maid	女佣
Maid	女佣
mail	邮件
Mail	邮件
Mailbox	邮箱
Mailer	信封
mailman	邮递员
main	主要
mainly	主要
maintaining	维持
major	重大的
Major	重大的
majored	主修
make	使
Make	使
maker	制作者
makes	品牌
Makes	使
makeup	化妆
makin	马金
making	制造
Making	制造
Malcom	马尔科姆
male	男
Malibu	马里布
mama	妈妈
man	人
Man	人
MAN	人
manager	经理
manchild	男孩子
maneuver	演习
mangled	错位
Mango	芒果
Manhattan	曼哈顿
maniac	疯子
manipulative	操控
manly	男子气
mannaquin	模特
mannequin	模特
Mannequins	模特
manner	方式
mannered	彬彬有礼
manuscript	手稿
manuver	角度机动
many	许多
map	地图
Mar	损伤
marathon	马拉松
Marc	渣
Marce	马尔塞
Marceau	·玛索
Marcel	马塞尔
march	游行
Mardi	狂欢
Margarita	玛格丽塔
margaritas	玛格丽塔
Marge	玛吉
Maria	玛丽亚
Marie	玛丽
marijuana	大麻
marinara	林纳拉
Marine	海洋
Mario	马里奥
Marjorie	马乔
Mark	标记
marker	标记
markers	标记
market	市场
marketing	营销
marking	印记
marks	分数
Marks	分数
Markson	马克森
Marlon	马龙
marmalades	果酱
marriage	婚姻
married	已婚
Married	已婚
Marries	结婚
marring	玷污
marry	结婚
Marry	结婚
marrying	结婚
Marsha	玛莎
Marshal	元帅
Marshall	马歇尔
marshmallow	棉花糖
marshmellows	棉花糖
Martha	玛莎
martini	马蒂尼鸡尾酒
Marty	马蒂
Mary	玛丽
mascara	睫毛膏
mascot	吉祥物
mashed	捣碎
massage	按摩
massager	按摩器
massages	按摩
massaging	按摩
masseuse	按摩师
Master	主
mastered	掌握
mastodon	乳齿象
Mastodon	乳齿象
masturbating	自慰
mat	垫
matador	斗牛士
match	比赛
matches	火柴
Matches	火柴
matchmaker	媒人
mate	伴侣
Materhorn	马特
material	材料
maternity	母道
math	数学
Math	数学
matrimony	婚姻
matter	物
matters	事项
Matthews	马修斯
mattress	床垫
Mattress	床垫
mattresses	床垫
mature	成熟
maturity	到期
Maureen	莫林
Maurice	莫里斯
max	最大
Max	马克斯
may	可以
May	可以
maybe	也许
Maybe	也许
Maye	马爷
mayo	梅奥
mayor	市长
Mazel	马泽尔
McDonald	麦当劳
McDowell	麦克道尔
McGwire	麦奎尔
me	我
Me	我
ME	我
meadow	草地
meal	膳食
meals	餐
mealworms	黄粉虫
mean	意思
meaner	寡情
meaning	含义
meaningful	富有意义的
meaningless	无意义的
means	手段
meant	意味着
meanwhile	与此同时
Meanwhile	与此同时
measure	测量
measured	测量
measuring	测量
meat	肉
mechanic	机械
mechanical	机械
mechanism	机制
Med	地中海
medals	奖牌
medical	医
medicine	医学
medieval	中世纪
mediterranean	地中海
medium	介质
Medley	混合
Mee	眉
meet	遇到
Meet	遇见
meeting	会议
Meeting	会议
meetings	会议
meets	符合
megabyte	兆字节
megabytes	兆字节
Mel	梅尔
Melanie	梅兰妮
Melba	梅尔巴
mellow	醇厚
melon	瓜
melt	熔化
Melt	熔化
melting	融化
member	会员
members	会员
membership	籍
memo	备忘录
Memo	备忘录
memories	回忆
Memories	回忆
memorise	记忆
memorize	记忆
memorizing	记忆
memory	记忆
memos	备忘录
men	男人
Men	男人
mendelevium	钔
Mendels	门德尔斯
menstruating	月经
ment	换货
mental	心理
Mental	心理
mentally	精神上
mention	提到
mentioned	提到
mentioning	提
Mento	嚼
mentor	导师
menu	菜单
menus	菜单
Mercedes	奔驰
Mercutio	茂丘西奥
mercy	怜悯
merit	值得
Merlot	梅洛
merriment	欢乐
merry	快活
Merry	快活
mess	食堂
message	信息
Message	信息
messages	消息
messed	搞砸
messenger	信使
Messier	梅西耶
messing	搞乱
messy	乱
met	会见
metal	金属
metaphor	隐喻
metaphorically	比喻
meteor	流星
meter	仪表
method	方法
methodical	有方法的
methods	方法
Mets	大都会
Mexican	墨西哥人
Mexico	墨西哥
Mi	弥
Miami	迈阿密
Michael	迈克尔
Michelle	米歇尔
Michener	米切纳
microscope	显微镜
microscopes	显微镜
microwave	微波
middle	中间
Middletown	米德尔敦
midget	侏儒
midgets	侏儒
midnight	午夜
Midnight	午夜
midterms	期中考试
midtown	市中心
might	威力
Might	威力
mighta	可能走
mighty	威武
mignon	牛排
migrate	迁移
Mike	麦克风
Milan	米兰
mildew	霉菌
miles	英里
mileu	环境
military	军事
milk	牛奶
Milk	牛奶
milkshake	奶昔
mill	磨
Miller	磨坊主
million	百万
millionaire	百万富翁
Millionaire	百万富翁
millions	百万
Milne	米尔恩
Milton	米尔顿
Milwaukee	密尔沃基
Min	敏
mind	心神
Mind	心神
minds	头脑
Mindy	柯以敏
mine	矿
Mine	矿
Minelli	米内利
mines	矿山
mingling	采风
miniature	微型
minimal	最小
minions	爪牙
Minnie	米妮
minor	次要
Minsk	明斯克
mint	薄荷
Mint	薄荷
mints	薄荷糖
minty	薄荷
minumum	最低限度
minus	减去
minute	分钟
minutes	分钟
Minutes	分钟
Mira	米拉
miracle	奇迹
Miracle	奇迹
mirror	镜子
mirrors	镜子
Mischa	米莎
miserable	悲惨
misery	苦难
Misery	苦难
mishap	不测
miss	小姐
Miss	小姐
missed	错过
Missed	错过
misses	错过
Misses	小姐
missing	失踪
mission	任务
Mississ	密西西比州
Mississippi	密西西比州
Missouri	密苏里州
missy	小姐
mistake	错误
mistakes	错误
mister	先生
Mister	先生
mistletoe	槲寄生
mistress	情妇
Mistress	情妇
misunderstanding	误解
misunderstood	误解
Mitchell	米切尔
mittens	手套
Mitzi	米齐
mix	混合
Mix	混合
mixed	杂
mixing	混合
mm	毫米
Mm	毫米
Mmm	嗯
Mmmm	嗯
Mo	莫
mock	嘲笑
mockolate	缀有蘑古力
Mockolate	缀有蘑古力
model	模型
modeler	建模
modeling	造型
models	楷模
modem	调制解调器
modern	现代
Modern	现代
moist	湿
moistening	润燥
moisturiser	保湿
moisturizer	保湿
mole	痣
mom	妈妈
Mom	妈妈
moment	时刻
moments	瞬间
Momma	妈妈
mommies	妈妈们
Mommies	妈妈们
mommy	妈妈
Mommy	妈妈
moms	妈妈
Moms	妈妈
Mon	周一
Moncia	莫妮卡
Monday	星期一
money	钱
Money	钱
monger	贩子
Monica	莫妮卡
monkey	猴
MONKEY	猴
monkeys	猴子
mono	单
monocle	单片眼镜
monogamy	一夫一妻制
Monopoly	垄断
monster	怪物
Montauk	蒙托克
Montgomery	蒙哥马利
month	月
monthly	每月一次
months	个月
Montreal	蒙特利尔
Montuak	蒙托克
Monty	蒙蒂
moo	哞
mood	心情
moody	喜怒无常
moon	月亮
mooning	表现出来的稀里糊涂
moonlight	月光
Moore	穆尔
moose	驼鹿
mop	拖把
Mop	拖把
mopeds	轻便摩托车
moping	闷闷不乐
mopping	扫荡
moral	道德
morale	情绪
morals	德
more	更多
More	更多
moring	莫林
mornin	清晨
Mornin	清晨
morning	早上
Morning	早上
mornings	早晨
moroccas	马拉卡斯
moron	白痴
morphin	吗啡
Morrison	莫里森
mortician	殡仪业者
Moses	摩西
mosey	漫步
Moskowitz	莫斯科维茨
Moss	苔藓
most	最
Most	最
mostly	大多
Mostly	大多
mother	母亲
Mother	母亲
moths	飞蛾
motif	主题
motion	运动
motional	运动
motivation	动机
motorcycle	摩托车
motto	座右铭
mouldings	角线
mountain	山
mouse	老鼠
Mouse	老鼠
mousse	摩丝
mousses	摩丝
moustache	胡子
moustasche	胡子
mouth	口
mouthful	一口
move	移动
Move	移动
moved	移动
movement	运动
moves	移动
movie	电影
movies	电影
movin	居无定所
moving	移动
Mr	先生
much	许多
Much	许多
MUCH	许多
mucus	粘液
muffin	松饼
muffins	松饼
mug	杯
mugs	马克杯
mulling	酝酿
multinational	跨国
multiple	多
Multiple	多
multiplex	多工
mumbles	曼波斯
Mummies	木乃伊
Mummys	的
munch	蒙克
Munchies	零食
muppet	布偶
Muppet	布偶
murder	谋杀
murders	谋杀
murky	模糊
Murray	穆雷
muscle	肌肉
muscles	肌肉
museum	博物馆
Museum	博物馆
museums	博物馆
mush	浓粥
mushroom	蘑菇
Mushroom	蘑菇
music	音乐
Music	音乐
musical	音乐
musician	音乐家
musicians	音乐家
musketeers	火枪手
Mussolini	墨索里尼
must	必须
Must	必须
musta	穆斯塔
mustard	芥末
mute	静音
my	我的
My	我的
myself	我
Myself	我
mystery	神秘
n	ñ
na	呐
Na	娜
Naa	萘乙酸
Naah	纳阿
Nada	纳达
nah	罗
Nah	罗
nail	钉
nailed	钉
nails	钉子
Nails	钉子
naked	裸
Naked	裸
Nam	南
name	名称
Name	名称
named	命名
names	名
namesake	同名
naming	命名
nana	娜娜
Nana	娜娜
nap	小憩
napkin	餐巾
napping	午睡
naps	小睡
Narnia	纳尼亚
narrowed	收窄
Nassau	拿骚
Nathan	弥敦道
national	国民
natural	自然
Natural	自然
naturally	自然
Naturally	自然
nature	性质
Naughty	淘气
nausea	恶心
nauseous	恶心
navy	海军
Navy	海军
ndashndash	的
near	近
nearly	几乎
neat	整齐
Neat	整齐
necessarily	一定
necessary	必要
neck	颈部
necklace	项链
necks	脖子
nectarines	油桃
Ned	斯内德
need	需要
Need	需要
needed	需要
needing	需要
needle	针
needles	针
needs	需求
Needs	需求
needy	贫穷
Neeson	尼森
negates	通过则无效
negative	负
negativity	消极
negotiation	谈判
neice	内测
neighbor	邻居
neighborhood	邻里
neighbors	邻居
neighbour	邻居
neighbourhood	邻里
neighbours	邻居
Neil	尼尔
neither	也不
Neither	也不
nephew	外甥
nephews	侄子
nerve	神经
nerves	神经
nervous	紧张
ness	内斯
net	净
Net	净
Netherlands	荷兰
network	网络
neuro	神经
neurosurgeon	神经外科医生
neurotic	神经质
neutral	中性
never	决不
Never	决不
nevermind	没关系
Nevermind	没关系
new	新
New	新
Newark	纽瓦克
newly	新
Newly	新
Newman	新人
news	新闻
newsletter	通讯
newspaper	报纸
newspapers	报纸
Newton	牛顿
next	下一个
Next	下一个
Ni	你
nice	不错
Nice	尼斯
nicely	很好
nicer	更好
nicest	最好
Nicholson	尼科尔森
Nick	缺口
nickel	镍
nickname	昵称
nicknames	昵称
Nicole	妮可
nicotine	尼古丁
niece	侄女
nieces	侄女
night	晚
Night	晚
nightie	睡衣
nighties	睡衣
nightmare	恶梦
nights	夜
nightstand	床头柜上
Nimitz	尼米兹
Nina	尼娜
nine	九
Nine	九
nineteen	十九
ninety	九十
Ninety	九十
ninja	忍者
ninth	第九
Ninth	第九
Nip	掐
nipple	乳头
nipples	乳头
nite	有限
no	没有
No	没有
NO	没有
Nobel	诺贝尔
nobody	没有人
Nobody	没有人
nocturnal	夜
nod	点头
nodded	点头
Nodded	点头
nodding	点头
noise	噪声
Noise	噪声
noises	噪音
noisy	吵
non	非
none	没有
None	没有
nonfat	脱脂
nono	不
Nono	不
Nonono	不不不
nononono	不不不不
Noo	野应
noodle	面条
noodles	面条
noon	中午
noone	没有人
nooo	拿去
Nooo	拿去
nooooo	真是没有
Nooooo	真是没有
nope	不
Nope	不
nor	也不
Nora	诺拉
normal	正常
normally	一般
Normally	一般
Norman	诺曼
north	北
North	北
nose	鼻子
noses	鼻子
nosing	突缘
nostril	鼻孔
not	不
Not	不
NOT	不
notch	缺口
note	注意
notepads	记事本
Notes	笔记
Noth	诺斯
nother	诺特尔
nothin	没什么
Nothin	没什么
nothing	没有
Nothing	没有
notice	注意
Notice	注意
noticed	注意到
notices	通告
noticing	注意到
nouse	公司内
Nova	新星
now	现在
Now	现在
NOW	现在
nowhere	无处
n't	不
N'T	不
nubbin	片体
nuclear	核
nude	裸体
Nude	裸体
nudes	裸体
Nudes	裸体
nudge	微调
nudity	裸露
nuget	的
Nuh	新加坡国立大学医院
number	数
Number	数
numbers	数字
nun	尼姑
nurse	护士
nursery	苗圃
nurses	护士
nurturing	培育
nut	坚果
nuts	坚果
nutshell	简而言之
nutty	疯狂的
oak	橡木
oat	燕麦
oath	誓言
oatmeal	麦片
oats	燕麦
Oberman	奥伯曼
objectively	客观地
objects	对象
obligated	责任
obligation	义务
oblivious	浑然不觉
oboe	双簧管
observe	守
obsessed	痴迷
obsession	困扰
Obsession	困扰
obsessive	强迫症
obstetrician	产科医生
obvious	明显
obviously	明显
Obviously	明显
occasion	场合
occasional	偶然
occasionally	偶尔
occasions	场合
occupied	占据
occur	发生
occured	发生
occurred	发生了
occurrence	发生
occurring	发生
ocean	海洋
o'clock	点
octagon	八角形
October	十月
octopus	章鱼
odd	奇
odds	可能性
O'Donnel	奥唐奈
odour	气味
of	的
Of	的
OF	的
off	离
Off	离
OFF	关闭
offbeat	另类
offence	罪行
offended	生气
offense	罪行
offensive	进攻
offer	提供
offered	提供
offering	供
offers	报价
office	办公室
Office	办公室
Officer	官
official	官方
officially	正式
officiating	礼
often	经常
Og	噩
oh	哦
Oh	哦
OH	哦
ohh	喔
Ohh	喔
OHH	喔
ohhh	哦~~
Ohhh	哦~~
Ohhhh	天上
oil	油
oils	油
Oink	哼
ok	好
Ok	好
OK	好
okay	好的
Okay	好的
Oke	奥凯
Okey	好
old	旧
Old	旧
older	旧的
oldest	最老的
olds	孩子
Ole	奥勒
olive	橄榄
Olive	橄榄
Oliver	奥利弗
olives	橄榄
Olympic	奥林匹克
Olympics	奥运会
omelet	煎蛋卷
Omelet	煎蛋卷
omnipotent	无所不能
OMnipotent	无所不能
on	上
On	上
ON	上
once	一旦
Once	一旦
one	一
One	一
Oneonta	奥尼昂坦
ones	那些
Ones	那些
oneself	自己
onion	洋葱
onions	洋葱
only	只要
Only	只要
onstage	在舞台上
onto	到
Oo	吴
ooh	嚯
Ooh	哦
Oon	奥安
oooh	哦
Oooh	哦
OOOH	哦
OoohhOoohh	喔
Oooo	呜
Oooooh	哇
Ooooooh	噢
oop	接力
Oops	哎呀
oozing	渗血
op	运
Op	欧普
open	打开
Open	打开
opened	打开
opener	揭幕战
openers	开罐器
openin	打开
opening	开盘
opens	打开
opera	歌剧
Opera	歌剧
operas	歌剧
operate	操作
operating	操作
operation	手术
Operation	手术
operations	操作
operators	运营商
opinion	意见
opossum	负鼠
Opossum	负鼠
opp	奥普
opponent	对手
opportunity	机会
opposable	对抗性
Opposable	对抗性
opposed	反对
opposite	相反
Oprah	奥普拉
opt	选择
opthamologist	眼科医生
opthamologists	眼科医生
option	选项
Option	选项
optional	可选的
options	选项
or	要么
Or	要么
oral	口服
orally	口头
orange	橙子
Orange	橙子
oranges	桔子
orchard	果园
order	订购
Order	订购
ordered	有序
orders	命令
ordinary	普通
oregano	牛至
Oreos	奥利奥
organ	器官
organic	有机
Organic	有机
organised	有组织的
organisms	生物
organized	有组织的
orgasms	性高潮
Orgy	狂欢
Orient	东方
originated	起源
ornaments	首饰
ornate	华丽的
Orson	奥森
orthodontist	牙齿矫正
Orthodontist	牙齿矫正
orthodontists	正畸医生
other	其他
Other	其他
others	其他
otherwise	除此以外
Otherwise	除此以外
Otherwords	也就是说
ottoman	奥斯曼帝国
Ouch	哎哟
oughta	现在应该
ounce	盎司
our	我们的
Our	我们的
ours	我们的
ourselves	我们自己
out	出
Out	退房
outa	欧塔
Outbreak	暴发
outer	外
outfit	配备
outgoing	传出
Outgoing	传出
outing	游览
outlet	出口
outlets	网点
outloud	响亮地
outreach	推广
outside	外
Outside	外
outstanding	优秀
outta	失控
oven	烤箱
Oven	烤箱
over	过度
Over	过度
OVER	过度
overalls	工作服
overboard	落水
overcoat	大衣
overhear	偷听
overheard	偷听
overlords	霸主
overly	过于
overnight	过夜
overpriced	高估
overrated	被高估
overs	旁白
overseas	海外
overshadowing	掩盖
oversized	过大的
oversizing	加大尺寸
overslept	睡过头
overwhelmed	不堪重负
ovulating	排卵
ow	流
Ow	嗷
owe	欠
owes	欠
own	拥有
Own	拥有
owned	拥有的
owner	所有者
OyOy	公司
Pa	霸
Pacino	帕西诺
pack	包
Pack	包
package	包
packaging	打包
packed	打包
packing	填料
pact	协议
pad	垫
paddling	戏
pagan	异教徒
page	页
Page	页
pager	呼叫器
pages	网页
paid	支付
pail	桶
pain	痛
Pain	痛
painful	痛苦
painfully	痛苦
painkillers	止痛药
paint	涂料
painted	绘
painter	画家
painting	绘画
paints	油漆
pair	对
pairs	对
pajamas	睡衣
PAJAMAS	睡衣
pal	朋友
palace	宫
Palace	宫
palaeontologist	古生物学家
paleontologist	古生物学家
paleontologists	古生物学家
paleontology	古生物学
palpable	明显的
pals	哥儿们
pan	泛
Pan	泛
pancakes	薄煎饼
panchetta	培根
panel	面板
panic	恐慌
panicked	惊慌失措
panicky	恐慌
pant	喘气
panther	豹
panties	衩
pants	裤子
Pants	裤子
pantsuit	裤装
panty	内裤
Paolo	保罗
papa	爸爸
paper	纸
papers	文件
paperwork	证件
Par	平价
parachute	降落伞
parade	游行
paramedics	医护人员
paranoid	偏执
Paranoid	偏执
pardon	赦免
Pardon	赦免
parent	亲
parenting	育儿
parents	父母
Parents	父母
Paris	巴黎
park	公园
Park	公园
Parka	大衣
parked	停
Parker	帕克
parking	停车处
Parkway	百汇
parlors	店
parrot	鹦鹉
Parrot	鹦鹉
part	部分
partially	部分
particle	粒子
particular	特定
particularly	尤其
partied	了宴会
parties	派对
partly	部分地
partner	伙伴
partners	伙伴
Partners	伙伴
parts	部分
party	派对
partying	派对
pass	通过
Pass	通过
passage	通道
passed	通过
passengers	乘客
passes	通行证
passin	经过的
passing	通过
passion	情
Passion	情
passionate	多情
passions	激情
passport	护照
Passport	护照
past	过去
pasta	意大利面条
Pastrami	熏牛肉
pastry	糕点
pat	拍
patch	补丁
pate	佩特
patent	专利
path	路径
pathe	帕泰
pathet	巴特
pathetic	可怜
Pathetic	青衫
patience	忍耐
patient	患者
patients	耐心
patio	庭院
Patrick	帕特里克
pattern	图案
Patti	帕蒂
Paul	保罗
Paulo	圣保罗
pause	暂停
pay	工资
Pay	工资
payback	回报
paycheck	薪水
payin	支付
paying	付款
payment	付款
Payroll	工资表
pays	支付
pea	豌豆
peace	和平
peaceful	平静的
peach	桃子
Peach	桃子
Peaches	桃子
peacock	孔雀
peanut	花生
Peanut	花生
peanuts	花生
pear	梨
pearls	珍珠
peas	豌豆
Pecan	胡桃
peck	啄
pecs	胸肌
pedantic	迂
pee	撒尿
peed	撒尿
peeing	撒尿
peek	窥视
peeking	偷看
peel	剥
Peel	剥
peep	窥视
Peep	窥视
peeper	偷窥者
peepers	偷窥者
peephole	窥视孔
pees	小便
peeve	忿怒
Peeves	皮皮鬼
pegged	钉住
pen	钢笔
penache	鹭
pencil	铅笔
pencils	铅笔
penetrate	穿透
penguin	企鹅
Penguins	企鹅
penicillin	青霉素
penis	阴茎
Penis	阴茎
Penn	佩恩
Pennsylvania	宾夕法尼亚
penny	一分钱
pens	笔
people	人
People	人
pepper	胡椒
Pepper	胡椒
Pepperidge	佩珀里奇
Pepponi	意大利辣味香肠
per	每
percent	百分
percentage	百分比
perceptive	感知的
perfect	完善
Perfect	完善
perfection	完美
Perfection	完美
perfectly	完美
perform	演出
performance	性能
performers	表演者
perhaps	也许
Perhaps	也许
period	期
Periodontist	牙周病
periscope	潜望镜
Perk	额外津贴
perked	重新振作
permanent	常驻
permitted	允许
perpendicular	垂直
person	人
personal	个人
Personal	个人
personality	个性
personally	亲身
personnel	人员
Personnel	人员
persons	人
perspective	透视
persuade	说服
Peru	秘鲁
pet	宠物
Pet	宠物
Pete	皮特
Peter	彼得
petite	娇小
Petrie	皮特里
pets	宠物
petticure	修脚
petty	小气
Petty	小气
Pfieffer	菲佛
pharmaceutical	制药
pharmacist	药剂师
pharmacy	药店
phase	相
Phase	相
PhD	博士
Pheebs	菲比
phenomenal	非凡的
phenomenon	现象
phew	表示不快
Phew	表示不快
Phil	菲尔
Philbin	菲尔宾
Phillips	菲利普斯
Philly	费城
Philosopher	哲学家
phlegm	痰
phobia	恐怖症
Phoebe	菲比
Phoebes	芙蓉坊
phone	电话
phonebook	电话簿
phoned	打电话给
phones	手机
phoning	中打电话
phony	假
photo	照片
photographer	摄影师
photography	摄影
photos	相片
phrase	短语
phrases	短语
Phyllis	菲利斯
physical	物理
physically	物理
physician	医师
physicist	物理学家
pick	挑
Pick	挑
picked	采摘的
pickin	接下去
picking	选择
pickle	泡菜
pickles	泡菜
picky	挑剔
picnic	野餐
Pictionary	画图猜词游戏
picture	图片
pictured	合照
pictures	图片
Pictures	图片
picturing	生动描述
pie	馅饼
Pie	馅饼
piece	片
pieces	件
pier	码头
pierced	刺穿
pig	猪
pigeon	鸽子
pigeons	鸽子
pigs	猪
pigtails	辫子
pile	桩
piles	痔
pilgrim	朝圣
pill	丸
pillar	柱
Pillman	皮尔曼
pillow	枕头
pillowcase	枕套
pillows	枕头
pills	丸
pilot	飞行员
pimp	拉皮条
pimple	疙瘩
pin	销
pinch	捏
pinching	捏
pine	松树
pink	粉
Pink	粉
Pinky	粉红
pinned	固定
Pinocchio	木偶奇遇记
pioneers	开拓者
pipe	管
piper	吹笛者
pirate	海盗
Pirates	海盗
pissed	生气
pissing	撒尿
pistachios	开心果
pit	坑
pitch	沥青
Pittsburgh	匹兹堡
pity	可怜
Pity	可怜
pizza	比萨
Pizza	比萨
pizzas	比萨饼
pizzeria	比萨店
place	地点
placenta	胎盘
places	地方
placing	配售
plague	鼠疫
plain	川
plan	计划
Plan	计划
plane	平面
planet	行星
Planet	行星
planetarium	天文馆
plank	板
planned	计划
planning	规划
plans	计划
plant	厂
plants	植物
plaques	斑
plastic	塑料
Plastic	塑料
plate	盘子
Plate	盘子
plates	板
platonic	柏拉图式的
platting	编结
Platting	编结
play	玩
Play	玩
Playboy	花花公子
played	发挥
player	播放机
players	玩家
playful	调皮
playin	发挥
playing	播放
playoffs	季后赛
plays	播放
playthings	玩具
Playthings	玩具
Plaza	广场
pleads	恳求
pleasant	愉快
please	请
Please	请
pleased	满意
pleasure	乐趣
Pleasure	乐趣
plenty	丰富
plese	普莱舍
Pliocene	上新世
plot	情节
plug	插头
plugged	插
plugs	插头
plumber	水管工人
plumbing	水暖
plunge	跳水
plunger	柱塞
plunk	普拉克
plural	复数
plus	加
Plus	加
pneumonia	肺炎
poach	偷猎
Pocanos	波科诺斯
pocket	口袋
Pocket	口袋
pocketbook	笔记本
pockets	口袋
Poco	波科
Poconos	波科诺斯
poem	诗
poems	诗
poet	诗人
poetry	诗歌
Poetry	诗歌
Poets	诗人
pogo	弹簧
point	点
Point	点
pointer	指针
pointing	指点
points	点
poisoned	中毒
poisoning	中毒
poke	戳
poker	扑克
poking	戳
Poland	波兰
pole	极
police	警察
policeman	警察
policemen	警察
policy	政策
polish	抛光
polite	有礼貌
political	政治
pollo	波洛
poltergeist	吵闹鬼
pony	小马
poo	便便
poodle	狮子狗
pool	池
pooped	筋疲力尽
poopy	猫粪
poor	较差的
Poor	较差的
pop	流行的
Pop	流行的
popcorn	爆米花
Pope	教皇
Popes	教皇
popped	膨化
popping	啪
poppy	罂粟
pops	持久性有机污染物
popular	流行
porcelain	瓷
porch	门廊
pornA	片
PORNA	片
porno	色情
Porsche	保时捷
port	港口
portion	一部分
portrayal	画像
pose	提出
Poseidon	波塞冬
posing	冒充
position	位置
positions	位置
positive	正
possession	所有权
possessions	财产
possibilities	可能性
possibility	可能性
possible	可能
possibly	或者
post	岗位
Post	岗位
poster	海报
posterior	后
posters	海报
postpone	推迟
Postpone	推迟
postponing	推迟
pot	锅
Potassium	钾
potato	土豆
Potato	土豆
potatoes	土豆
Potatoes	土豆
potential	潜在
pots	罐
Potter	制陶工人
pottery	陶器
Poughkeepsie	波基普西
Poulet	布莱
pounce	猛扑
pound	磅
pounding	重击
pounds	英镑
pour	倾
pouring	浇注
pouty	微翘
Pow	战俘
power	功率
Power	功率
powered	动力
powerful	强大
powers	权力
pox	痘
practically	几乎
practice	实践
practicing	练
practising	练
Prague	布拉格
praise	赞美
prank	恶作剧
prawns	对虾
pre	预
precaution	预防
precious	珍贵
Precision	精确
Predators	捕食者
predicament	困境
predictable	可预测的
prefer	比较喜欢
preference	偏爱
preferred	首选
prefers	喜欢
pregnancy	怀孕
Pregnancy	怀孕
pregnant	孕
Pregnant	孕
Prehistoric	史前
prep	预备
preparation	制备
prepare	准备
Prepare	准备
prepared	准备
preparing	准备
preppy	预科生
present	当下
presentation	介绍
presented	呈现
Presenting	呈现
presents	礼物
Presents	礼物
president	主席
President	主席
press	按
Press	按
pressed	压制
pressing	紧迫
pressure	压力
pressures	压力
pressuring	施压
presumably	想必
pretend	假装
pretended	假装的
pretending	假装
Pretensous	自命不凡
prettier	漂亮
prettiest	最漂亮
pretty	漂亮
Pretty	漂亮
pretz	百力滋
pretzel	椒盐卷饼
price	价钱
prices	价格
pride	自豪
Pride	自豪
priest	牧师
Priesthood	圣职
primarily	主要
prime	主要
Prince	王子
princess	公主
Princess	公主
print	打印
printed	印刷的
printing	印花
prison	监狱
prisoner	囚犯
privacy	隐私
private	私人的
Private	私人的
prize	奖
Prize	奖
pro	亲
probably	大概
Probably	大概
problem	问题
Problem	问题
problems	问题
procedure	程序
process	处理
processing	处理
processor	处理器
processors	处理器
producer	制片人
product	产品
production	生产
profession	职业
professional	专业的
Professor	教授
profile	轮廓
profit	利润
program	程序
progress	进展
project	项目
projectile	抛射物
projections	预测
prom	舞会
promise	诺言
Promise	诺言
promised	许诺
promote	促进
promoted	提拔
promotion	提升
pronounce	发音
pronounced	宣判
pronounces	宣告
proof	证明
proofing	打样
proofs	样张
Property	属性
proposal	提案
Proposal	提案
propose	提出
proposed	建议
proposes	建议
proposing	建议
props	道具
pros	利弊
protected	保护
protective	保护的
protects	保护
proud	骄傲
proudly	傲然
prove	证明
proved	证明
proves	证明
provide	提供
provided	提供
proving	证明
prune	修剪
pry	撬
psyche	精神
psyched	激动
psychiatrist	心理医生
psychic	精神
psycho	心理
psychological	心理
psychology	心理学
psychopath	精神病患者
pub	酒馆
puberty	青春期
public	上市
publicity	公开
published	发表
puck	冰球
PUCK	冰球
puddin	布丁
puddle	水坑
Puerto	波多黎各
puff	噗
pull	拉
pulled	拉
pulling	拉
Pulling	拉
pulls	拉
pulp	纸浆
pulse	脉冲
puma	美洲狮
pumpkin	南瓜
Pumpkin	南瓜
pumps	泵
punch	冲床
Punch	冲床
punches	拳
puncture	刺
punctured	刺破
punish	惩治
punishable	该罚的
puppet	木偶
puppets	木偶
puppies	小狗
Puppies	小狗
puppy	小狗
purchase	采购
purchasing	购买
pure	纯
purple	紫色
purpose	目的
purred	咕哝
purse	钱包
purses	皮包
pursue	追求
pursued	追求的
pursuing	追求
push	推
Push	推
pushed	推
pushing	推动
pushy	富有进取心的
put	放
Put	放
puts	看跌期权
putting	把
puzzle	难题
puzzles	谜题
pyjama	睡衣
pyramid	金字塔
quack	嘎嘎
Quack	嘎嘎
quacking	还会发出叽叽嘎嘎
qualifications	资格
qualified	合格
qualifies	素质要求
quality	质量
Quality	质量
quantities	数量
quarters	住处
quartet	四重奏
quartz	石英
Quartz	石英
que	阙
queen	女王
Queen	女王
Queens	皇后
question	题
Question	题
questioning	疑问
questions	问题
quiche	乳蛋饼
quiches	乳蛋饼
quick	快
Quick	快
quickie	匆匆
quickly	很快
quiet	安静
Quiet	安静
quieter	安静
quietly	悄悄
quin	之五
Quincy	昆西
quit	放弃
Quit	放弃
quite	相当
quitters	戒烟
quitting	戒烟
quiz	测验
Ra	镭
rabbi	拉比
Rabbi	拉比
rabbit	兔子
Rabbit	兔子
rabbits	兔
Rabbits	兔
rabies	狂犬病
racecar	赛车
Racer	赛车
Rach	瑞秋
Rachel	雷切尔
racist	种族主义者
rack	架
Rack	架
racket	球拍
racquetball	壁球
Racquetball	壁球
radar	雷达
radiator	散热器
Radiator	散热器
radiators	散热器
radio	无线电
radioactive	放射性的
raft	筏
raggedy	褴褛的
Raggedy	褴褛的
raid	袭击
rain	雨
Rainbow	彩虹
Raindrops	雨滴
rained	下雨
raining	下雨
rainy	多雨的
Rainy	多雨的
raise	提高
raised	提高
raisin	葡萄干
raising	提高
raisins	葡萄干
Ralph	拉尔夫
ram	内存
rambled	天马行空
rambunctious	粗暴
Ramone	雷蒙斯
ramp	舷梯
ran	跑
Randall	兰德尔
Randy	兰迪
rang	穰
ranger	游侠
Ranger	游侠
Rangers	流浪者
rapidly	急速
Raquel	拉奎尔
raquetball	壁球
rare	罕见
rat	鼠
rated	额定
rather	宁
rats	大鼠
rattles	摇铃
raved	妄言
Raven	掠夺
ravioli	馄饨
raw	生的
Raymond	雷蒙德
razor	剃刀
re	回覆
're'	回覆
reach	达到
reached	到达
reaching	到达
react	应对
reacting	反应
reaction	反应
read	读
Read	读
reader	读者
reading	读
reads	读
ready	准备
Ready	准备
Reaffirms	重申
real	真实
Real	真实
realise	实现
realised	实现
realises	实现
realistic	实际
reality	现实
realize	实现
realized	实现
realizes	实现
realizing	实现
really	真
Really	真
rear	后
rearranged	重排
reason	原因
reasonable	合理
reasons	原因
reassure	再保证
reattaching	重新连接
rebound	篮板球
rebuild	重建
rebuilding	重建
recall	召回
receipt	收据
receive	接收
received	收到
receiver	接收器
receiving	接收
recent	最近
recently	最近
reception	招待会
receptions	招待会
reciept	收据
recipe	食谱
recipes	食谱
reckless	鲁莽
recognise	认识
recognition	承认
recognize	认识
recollection	回忆
recommend	推荐
recommended	推荐的
recommending	建议
reconcile	调和
reconstituted	重组
record	记录
recorded	记录
recording	记录
recover	恢复
recurring	经常性
recycle	回收
red	红色
Red	红色
Redford	雷德福
redo	重做
redoing	重做
reduce	降低
reduction	减少
redused	减少
Ree	稀土元素
refer	参考
reference	参考
referred	简称
refers	指
refill	充值
reflex	反射
refrigerator	冰箱
refrigerators	冰箱
refuse	垃圾
refuses	拒绝
regimented	刻板
regional	区域性
Regis	雷吉斯
register	寄存器
regret	后悔
regrets	遗憾
regular	定期
Regular	定期
regulars	常客
regulations	法规
rehearsal	排演
rehearsals	排练
rehearse	排练
rehearsing	排练
Reid	里德
reimburse	补偿
reincarnated	转世
reject	拒绝
rejection	拒绝
rejections	拒绝
rejoin	归队
related	有关
relationship	关系
relationships	关系
Relative	相对的
relatively	相对
relax	放松
Relax	放松
relaxed	轻松
relied	靠
relief	浮雕
relieved	安心
Relieved	安心
relish	滋味
reluctant	不情愿
remains	遗迹
remake	翻拍
remaking	再造
remarkably	异常
rematch	复赛
remedy	补救
remember	记得
Remember	记得
remembered	记得
Remembered	记得
remembering	记忆
remind	提醒
Remind	提醒
reminded	提醒
reminds	提醒
remodel	改装
RemorayRemoray	医生
Remore	遥远而明亮
remote	远程
remotely	远程
remoto	偏远落后地区
remove	去掉
rent	出租
Rent	出租
rented	租
renter	承租人
rents	租金
repeat	重复
repellant	防护剂
repeller	排斥
replace	更换
replaced	更换
report	报告
Reporter	记者
representation	表示
represents	代表
reps	代表
request	请求
require	要求
required	需要
requires	要求
Reruns	重播
rescedule	改期
rescue	拯救
rescued	获救
research	研究
researcher	研究员
resent	愤恨
resentment	怨恨
reservation	保留
reservations	预订
Residence	住宅
resigned	辞职
resist	抗
resistance	抵抗性
resolve	解决
resotre	恢复
respect	尊重
respected	尊敬
respond	响应
response	响应
responses	回复
responsibilities	责任
responsibility	责任
responsible	主管
rest	休息
restaurant	餐厅
restaurants	餐馆
resting	休息
restraining	限制
restraunt	餐厅
restrooms	厕所
restrung	去换
rests	休息
result	结果
results	结果
resume	恢复
resumes	简历
resurfaces	复出
retailers	零售商
retainer	定位器
retardant	阻燃
retarded	智障
rethink	反思
retiling	换瓦
retract	撤回
retraction	回缩
retraining	再培训
return	返回
Return	返回
returned	回
returning	回国
reunion	团圆
Reunited	重逢
revel	陶醉
revelation	启示
revelling	陶醉
revenge	复仇
reverse	相反
review	评论
revolution	革命
revolutionary	革命的
reward	奖励
Rex	雷克斯
Rhonda	朗达
rhyme	韵
rhymes	童谣
rhyming	押韵
rhythm	韵律
Rhythm	韵律
rib	肋
ribbed	罗纹
ribbon	带
riboflavin	核黄素
ribs	肋骨
rice	白饭
rich	丰富
Rich	丰富
Richard	理查德
Richie	任贤齐
Rick	干草堆
Rico	波多黎各
ricocheted	跳飞
rid	摆脱
ridding	李尔庭
ride	骑
Rider	骑士
rides	游乐设施
ridge	岭
ridicule	嘲笑
ridiculed	讥
ridiculous	荒谬
ridiculously	可笑
riding	骑术
Riffs	即兴
Rifts	裂痕
Riggs	里格斯
righ	右击
right	对
Right	对
righteous	正义
rights	权利
righty	右倾
riled	激怒
rim	轮缘
ring	环
Ring	环
ringing	铃声
rings	戒指
Rings	戒指
ringside	马戏团
rinse	冲洗
ripped	撕开
ripping	翻录
risk	风险
risking	冒着
risks	风险
Ritalin	利他林
Ritter	里特尔
ritual	仪式
river	河
River	河
Rivera	里维拉
Riverside	河边
road	路
Road	路
roast	烤
Rob	抢
robbed	被抢
robbery	抢劫
Robbie	罗比
robbing	劫财
Robbins	罗宾斯
Robbinson	罗宾逊
robe	长袍
Robert	罗伯特
robots	机器人
rock	岩石
Rock	岩石
Rockefeller	洛克菲勒
rocket	火箭
Rockettes	火箭女郎
rocks	岩石
Rocky	洛基
RockysRockys	了
rod	竿
Rod	竿
rode	骑着车
rodeo	圈地
Rodney	罗德尼
Rodrigo	罗德里戈
Roger	罗杰
rogue	流氓
Roland	罗兰
role	角色
roles	角色
roll	滚
Roll	滚
rolled	热轧
roller	滚筒
rollin	罗林
rolling	压延
rolls	劳斯莱斯
Romania	罗马尼亚
romantic	浪漫
Rome	罗马
rommmates	室友
romp	欢蹦乱跳
Rona	罗纳
roo	袋鼠
roof	屋顶
Roof	屋顶
room	房间
Room	房间
roomate	室友
roomie	室友
roommate	室友
roommates	室友
rooms	客房
rooster	公鸡
rooting	生根
rope	绳
Roper	罗珀
Rose	玫瑰
Rosen	罗森
roses	玫瑰
Ross	罗斯
Rosselini	罗西里尼
Rossy	罗西
RostinsRostins	一家
rot	腐烂
rotator	肩
Roth	罗斯
rotisserie	烤肉店
rotten	烂
rough	粗
Rough	粗
Roughy	罗非鱼
roulettes	轮盘赌
round	回合
Round	回合
rounding	四舍五入
rounds	发
route	路线
Route	路线
row	行
Roy	罗伊
Roz	罗兹
rub	擦
Rub	擦
rubber	橡胶
rubbing	擦
rubs	磨
rude	无礼
Rudolph	鲁道夫
ruffle	生气
rugby	橄榄球
Rugby	橄榄球
ruin	废墟
ruined	毁了
ruining	破坏
rule	规则
ruler	统治者
rulers	统治者
rules	规则
rum	朗姆酒
rumour	谣言
rumours	传闻
run	跑
Run	跑
runnin	奔跑
running	赛跑
runs	运行
rush	赶
Rush	赶
rushed	冲
rushing	冲
Rushmore	拉什莫尔
Russ	拉斯
Russia	俄国
Russian	俄语
rust	锈
Rust	锈
rusty	生疏
rut	发情
Ruth	怜悯
Ryan	瑞安
Ryder	莱德
s	小号
's	的
'S	作者
sabotage	破坏
Sabrina	萨布丽娜
sack	袋
sacramental	圣
sacred	神圣
sacrifice	牺牲
sad	伤心
sadder	令人悲哀
saddest	最可悲
sadness	悲
safari	苹果浏览器
safe	安全
safely	安然
safer	更安全
Safer	更安全
safety	安全
saffron	藏红花
sage	智者
saggy	下垂
said	说过
Said	说过
sailed	航行
sailor	水手
Sak	萨克
sake	清酒
sakes	缘故
Sal	萨尔
salad	沙拉
salads	沙拉
salami	萨拉米
salary	薪水
sale	拍卖
Salem	塞勒姆
sales	销售
Sales	销售
salesman	推销员
saline	盐水
salmon	三文鱼
Salmon	三文鱼
salmonella	沙门氏菌
salt	盐
salts	盐
Salty	咸
salute	敬礼
Sam	山姆
same	相同
Same	相同
sample	样品
Sample	样品
San	圣
sand	砂
Sanders	桑德斯
Sandra	桑德拉
sandwich	三明治
sandwiches	三明治
Sandwiches	三明治
sandy	沙
Sandy	沙
sane	明智的
sang	唱
sangria	西班牙果酒
Sanitation	卫生
sanity	明智
Sanskrit	梵文
Santa	圣诞老人
Santos	桑托斯
SapienSapien	的
Sapiens	智人
Sarah	莎拉
Sarandon	萨兰登
Saratoga	萨拉托加
sarcastic	讽刺
Sat	星期六
Satan	撒但
satin	缎
Satin	缎
satisfied	满意
satisfying	满意的
Saturday	星期六
Saturn	土星
sauce	酱
saucy	俏皮
Saucy	俏皮
sauna	桑拿
savage	野蛮人
Savage	野蛮人
save	保存
Save	保存
saved	保存
saver	保护程序
saves	节省
savin	萨万
saving	保存
Saving	保存
savings	储
savor	品尝
savory	香香
saw	锯
Saw	锯
say	说
Say	说
sayin	在说
saying	话
says	说
Says	说
scale	规模
scar	瘢痕
scare	吓
scared	害怕
Scared	害怕
scares	恐慌
scarf	围巾
scarier	可怕
scariest	最可怕的
scaring	疤痕
Scarsdale	斯卡斯代尔
scarves	围巾
scary	害怕
Scary	害怕
scenario	脚本
scenarios	场景
scene	现场
scenes	场景
Schaffer	谢弗
schedule	时间表
schedules	时间表
Schiffer	希弗
scholarship	奖学金
school	学校
School	学校
schoolchildren	小学生
schools	学校
science	科学
Science	科学
scientific	科学
scientist	科学家
Scientist	科学家
scientists	科学家们
scissors	剪刀
scoff	嘲笑
scones	司康饼
scooch	挤一挤
scoot	溜走
score	得分了
Score	得分了
scored	进球
scotch	苏格兰人
Scotch	苏格兰人
Scotia	斯科舍省
Scott	斯科特
Scotty	懥
SCOUT	侦察
scouts	侦察兵
Scouts	童子军
Scrabble	乱涂
scramble	争夺
Scranton	斯克兰顿
scrape	刮
scrapes	擦伤
scratch	刮
scratched	划伤
scratching	搔抓
scratchy	发痒的
scream	惊叫
screamed	尖叫
Screamed	尖叫
screamer	骇人听闻的标题
screaming	尖叫
screen	屏幕
screening	筛查
screw	拧
Screw	拧
screwed	拧
script	脚本
scripts	脚本
scrub	擦洗
scrum	争球
sculpting	雕刻
scum	浮渣
Se	硒
sea	海
Sea	海
seagulls	海鸥
seal	密封
seals	密封件
seamstress	裁缝
Sean	肖恩
search	搜索
searched	搜索
Seasame	芝麻
seashell	贝壳
seashores	海岸
season	季节
Season	季节
Seasons	四季
seat	座位
seatbelts	安全带
seats	席
sec	秒
second	第二
Second	第二
secondary	次要
seconds	秒
secret	秘密
Secret	秘密
secretary	秘书
secretive	隐秘
secretly	偷偷
secrets	秘密
section	部分
security	安全
Sedaka	濑高
sedative	镇静剂
seduce	勾引
seduces	生情愫
see	看到
See	看到
seed	种子
seeing	眼看
seek	寻求
seem	似乎
seemed	似乎
seems	似乎
seen	看到
sees	看到
seize	抢占
seizing	抓住
selection	选择
self	自
selfish	自私
sell	卖
sellin	出卖
selling	销售
sells	塞尔斯
selves	自我
semen	精液
send	发送
sEnd	发送
Send	发送
sending	发出
sends	发送
senior	前辈
sense	感
sensed	感应
senses	感官
sensitive	敏感
Sensitive	敏感
sent	发送
sentence	句子
sentenced	判刑
sentences	句子
sentiment	情绪
separate	分离
separated	分离
separately	分别
separating	分离
septum	隔膜
sera	血清
Serengetti	塞伦盖蒂
Sergei	谢尔盖
Sergio	塞尔吉奥
serious	严重
Serious	严重
seriously	认真地
Seriously	认真地
seriousness	严肃
serve	服务
served	提供服务
serves	供应
service	服务
services	服务
Services	服务
serving	服务
session	会议
set	组
Set	组
sets	套
settin	设置搜索
setting	设置
settings	设置
settle	解决
Settle	解决
settled	安定
Seuss	苏斯
seven	七
Seven	七
seventeen	十七
Seventeen	十七
seventh	第七
seventies	七十年代
seventy	七十
Seventy	七十
several	一些
severe	严重
severely	严重
sew	缝
sewer	下水道
sex	性别
Sex	性别
sexier	性感
sexiest	最性感
sexist	性别歧视
sexual	有性
sexually	性
Sexually	性
sexy	性感的
Sexy	性感的
Sh	嘘
shadow	阴影
shaft	轴
shake	抖动
shaken	动摇
shall	应
Shall	应
shallow	浅
shame	耻辱
Shame	耻辱
shampoo	洗头
Shannon	香农
shape	形状
shaped	成形
shapes	形状
Shapiro	夏皮罗
share	分享
shared	共享
shares	分享
sharing	分享
shark	鲨鱼
sharp	尖锐
sharpened	削尖
sharpener	卷笔刀
Sharper	沙坡
shave	刮胡子
shaved	剃光
shaves	刮胡子
shaving	刮
she	她
She	她
Shea	乳木果
shed	棚子
sheep	羊
sheer	绝对
sheet	片
sheets	床单
shell	贝壳
Shelley	雪莱
shellfish	贝类
shells	炮弹
Shelly	雪莉
shelter	庇护
Shepard	谢泼德
Sherman	谢尔曼
sherrif	郡治安官
shes	畲族
Shes	畲族
shh	嘘
Shh	嘘
shhh	嘘
Shhh	嘘
Shhhh	嘘
shiatsu	指压按摩
shield	屏蔽
Shielding	屏蔽
shifts	转移
shine	闪耀
shining	闪亮的
Shining	闪亮的
shiny	闪亮
ship	船
Ship	船
shipped	运
shipping	运输
ships	船舶
shire	郡
Shirley	雪莉
shirt	衬衫
shirts	衬衫
shocks	震荡
shoe	鞋
shoelaces	鞋带
shoes	鞋
Shoo	嘘
shoop	咻
Shoop	咻
shooping	咻
shoot	射击
Shoot	射击
shootin	乱射
shooting	射击
shoots	芽
shop	店
shoppin	购物袋
shopping	购物
short	短
Short	短
shorter	短
shortly	不久
shorts	短裤
shot	射击
Shot	射击
shotgun	滑膛枪
shots	镜头
should	应该
Should	应该
shoulder	肩
shoulders	肩膀
shouldnt	不应该
shouldn't	不能
shout	喊
shouting	叫喊
shove	推
shovel	铲
shoveling	铲
show	节目
Show	节目
showbusiness	影视圈
showed	显示
shower	淋浴
showering	淋浴
showers	阵雨
showgirl	歌女
showin	显示
showing	展示
shown	显示
showroom	展厅
shows	节目
Showtime	开演时间
shredded	切丝
shrieking	尖叫
shrimp	虾
shrink	收缩
Shropshire	什罗普
shuffle	拖曳
shunned	回避
shush	嘘
shushing	嘘
shut	关闭
Shut	关闭
shutting	关闭
shuttle	穿梭
shy	害羞
Si	硅
siamese	暹
sibling	兄弟
sick	生病
Sick	生病
sicker	病情加重
sickness	疾病
side	侧
sides	双方
sidestepped	回避
sidewalk	人行道
Sidney	西德尼
Siegal	西耶戈尔
sight	视力
sightless	盲目的
sign	标志
Sign	标志
signature	签名
signed	签
signing	签约
signs	迹象
Silence	安静
silences	沉默
silently	默默
silk	丝
silly	愚蠢
silver	银
Silverman	西尔弗曼
silverware	银器
Silvia	西尔维娅
simian	类人猿
similar	类似
Simmons	西蒙斯
Simon	西蒙
simple	简单
simply	只是
simulate	模拟
simulates	可模拟
sin	罪
since	以来
Since	以来
sing	唱
singers	歌手
singing	唱歌
Singing	唱歌
single	单
sink	下沉
sip	啜
sir	先生
Sir	先生
sissy	娘娘腔
sister	妹妹
Sister	妹妹
SISTER	妹妹
sisters	姐妹
Sisters	姐妹
sit	坐
Sit	坐
sites	网站
sits	坐镇
sitter	保姆
sittin	坐在
sitting	坐在
situation	情况
six	六
Six	六
sixes	乱七八糟
sixteen	十六
sixteenth	第十六
sixth	第六
sixty	六十
Sixty	六十
size	尺寸
sized	大小
sizes	大小
skates	冰鞋
Skates	冰鞋
skating	溜冰
skedaddle	斯基达德尔
ski	滑雪
skier	滑雪者
skiing	滑雪
skills	技能
skimp	吝啬
skin	皮肤
skinny	枯瘦
skins	皮
skipped	跳过
skipping	跳绳
skirt	短裙
skit	小品
skull	头骨
sky	天空
Skywalker	天空步行者
slack	松弛
slam	猛撞
slammed	抨击
slap	拍击
slapping	打耳光
slash	削减
slather	涂满
slaughtered	屠宰
slaw	色拉
Slays	杀害
sleep	睡觉
sleeper	轨枕
sleepers	枕木
sleeping	睡眠
sleeps	睡觉
sleepy	困
sleeve	袖
Sleeve	袖
sleighbells	雪橇铃
slept	睡
slice	切片
sliced	切片
Sliced	切片
slices	片
slid	下滑
slide	滑动
slides	幻灯片
Sliding	滑动
slight	轻微
slightest	丝毫
slightly	略
slimmer	苗条
Slinky	苗条
slip	滑
slipped	下滑
slippers	拖鞋
slipping	滑倒
slit	裂缝
sloppiness	草率
sloppy	稀松
slots	插槽
slouch	伛偻
slow	慢
slowed	放缓
slower	慢点
slugger	猛男
slumber	睡眠
Slut	懒妇
smack	拍击
smacked	轰出
smacks	嫌
small	小
Small	小
smaller	小
smallest	最少
smart	聪明
smarter	聪明
smartest	最聪明的
smashed	被砸
smeared	涂
smell	闻
Smell	闻
smelled	闻
smelling	闻
smells	气味
Smells	气味
smelly	臭
Smelly	臭
smelt	冶炼
smidge	【熊
smile	微笑
Smile	微笑
smiled	笑笑
smiling	微笑
smitten	重拳出击
smock	罩衫
smoke	抽烟
Smoke	抽烟
smoked	熏制
Smoked	熏制
smoker	抽烟者
smokes	抽烟
smokey	烟熏
Smokey	斯莫基
smokin	斯莫
smoking	抽烟
Smoking	抽烟
smooth	平滑
Smooth	平滑
smoothest	流畅的
smudgy	褛
smush	斯马什
snack	小吃
Snack	小吃
snacks	小吃
snake	蛇
Snake	蛇
snakes	蛇
snaking	蛇形
snap	卡
snapped	抢购
sneak	潜行
sneakers	球鞋
sneakin	潜入
sneeze	喷嚏
sneezed	打个喷嚏
sneezers	打喷嚏
sneezes	打喷嚏
sneezy	打喷嚏
Snoopy	史努比
snooty	傲慢
Snooty	傲慢
snore	鼾声
snoring	打鼾
snort	哼
snow	雪
snowballing	滚雪球
snowman	雪人
snowstorm	暴风雪
snowy	似雪
snubbed	冷落
snug	舒适
Snuggles	挨近
so	所以
So	所以
soak	浸泡
soaking	浸水
soap	肥皂
Soap	肥皂
soapy	肥皂水
sobbing	抽泣
sober	清醒
soberly	清醒
soccer	足球
social	社会
society	社会
Society	社会
sock	袜子
socket	插座
socks	袜子
soda	苏打
sodas	汽水
sofa	沙发
soft	柔软的
softball	垒球
softener	柔软剂
softest	柔软的
Softly	轻轻的
Soho	苏荷
soilder	士兵
soir	晚报
sold	出售
solid	固体
solution	解
solve	解决
solved	解决了
sombreros	阔边帽
some	一些
Some	一些
somebody	谁
Somebody	谁
someday	日后
somehow	不知何故
somehting	某物
someone	有人
Someone	有人
someplace	某个地方
SomerfieldSomerfield	的
somethin	事端
Somethin	事端
something	某物
Something	某物
sometime	某时
Sometime	某时
sometimes	有时
Sometimes	有时
somewhere	某处
Somewhere	某处
somone	有人为
son	儿子
Son	儿子
song	歌曲
Song	歌曲
songs	歌曲
sonogram	声像
Sony	索尼
soo	洙
Soo	洙
soon	不久
sooner	早
Sooner	迟早
Soother	抚慰者
soothes	舒缓
Soothing	抚慰的
Sophie	索菲
sophisticated	复杂的
Sophisticated	复杂的
sore	疮
Sorentino	索伦蒂诺
sores	疮
sorority	联谊会
sorrow	悲哀
sorry	抱歉
Sorry	抱歉
sort	分类
sorta	八九不离十
sorts	排序
soul	灵魂
soulmate	心心相印
sound	声音
Sound	声音
sounded	满面
sounds	声音
Sounds	声音
soup	汤
Soupy	糊状的
sour	酸
source	资源
sowed	播种
sowin	松畇
sowing	播种
soy	黄豆
spa	温泉
space	空间
Space	空间
spacecrafts	航天器
spaceship	飞船
spades	黑桃
spaghetti	意大利面
Spain	西班牙
spandex	斯潘德克斯弹性纤维
Spanish	西班牙语
spare	备用
Spare	备用
sparkly	闪闪发光的
Sparkly	闪闪发光的
Sparky	活泼的
Sparrow	麻雀
spasm	痉挛
spatters	飞溅
spatula	抹刀
spatulas	铲
spaz	怪人
speacial	特别
speak	说话
speaker	扬声器
speaking	请讲
Speaking	请讲
special	特别
Special	特别
specializing	专业
specially	特别
specials	特价
species	种类
specifically	特别
spectacular	壮观
spectacularly	壮观
spectre	幽灵
speech	言语
speed	速度
Speed	速度
speedily	赶紧
speedster	欧宝
spell	拼写
spelled	拼写
spelling	拼字
Spellman	斯佩尔曼
spend	花
spender	富豪
spending	开支
spends	花
spent	花费
sperm	精子
Sperm	精子
spewing	喷涌
spice	香料
spider	蜘蛛
Spiderman	蜘蛛侠
spiders	蜘蛛
spied	窥探
Spike	穗
spill	洒
spilled	洒
spilt	洒
spin	纺
Spin	纺
spinal	脊
Spindler	德勒
spine	脊柱
spinning	纺织
Spinning	纺织
spins	自旋
spinster	独身主义者
spirit	精神
spit	吐
Spit	吐
spite	尽管
spitting	随地吐痰
Splash	溅
split	分裂
Split	分裂
splitting	分裂
Splotch	油渍
Spock	斯波克
spoil	溺爱
spoiled	坏
Spoiled	坏
spoke	辐
spoken	说
spokes	辐条
spokesmodel	代言
sponsor	赞助
spontaneous	自发
spooky	幽灵般的
spoon	勺
Spoon	勺
spoons	匙
sport	运动
sporting	运动的
sports	体育
Sports	体育
spot	点
spots	斑点
spotted	斑
spotter	去污剂
spout	喷口
sprain	扭伤
spray	喷雾
Spray	喷雾
spraying	喷
spread	传播
spreadsheet	电子表格
spring	弹簧
spritz	斯普茨
spritzer	汽酒
spun	纺
spunky	容易发怒
spy	间谍
spying	间谍
sqare	广场
squad	队
square	广场
Square	广场
squares	广场
squat	蹲
squeaky	吱吱
squeeze	挤
squeezed	挤压
squint	眯
squinting	眯眼
squirming	蠕蠕
squirmy	扭来扭去
squirrel	松鼠
squirts	鞘
squish	果酱
squishing	压扁
Stabilization	稳定
Stacy	斯泰西
stadium	体育场
Stadium	体育场
stage	阶段
staging	分期
stain	弄脏
stairs	楼梯
stakes	赌注
Stalin	斯大林
stalk	茎
stalker	死缠烂打
stalkers	跟踪狂
stalking	盯梢
stamina	耐力
stamp	邮票
stand	支架
Stand	支架
standard	标准
Standby	支持
standin	站在
standing	常设
Standing	常设
STANDING	常设
stands	站立
stank	发臭
stapler	订书机
star	星
Star	星
Starbucks	星巴克
stare	盯
Stare	盯
starin	盯着
staring	凝视
starring	主演
stars	明星
start	开始
started	开始
starters	首发
starting	开始
Starting	开始
starts	启动
starving	挨饿
state	州
State	州
statement	声明
STATEMENT	声明
states	状态
States	状态
static	静态的
station	站
Station	站
Statistics	统计
Staton	斯塔顿
Statue	雕像
status	状态
stay	留
Stay	留
STAY	留
stayed	住
staying	住
stays	入住
steady	稳定
Steady	稳定
steak	牛扒
steaks	牛排
steal	偷
stealer	窃取
stealing	偷窃行为
steals	抢断
steam	蒸汽
steamed	蒸熟
steaming	腾腾
steamy	潮湿
steel	钢
Steele	斯蒂尔
steep	陡
steer	驾驶
Steffi	斯特芬
stegosaurus	剑龙
Stegosaurus	剑龙
Steiger	斯泰格尔
Stein	斯坦
Stella	斯特拉
sten	斯登
step	步
Step	步
stepdad	继父
stepfather	后爹
Stephanie	斯蒂芬妮
Stephanopoulos	普洛斯
Stephen	斯蒂芬
stepped	加强
stepping	步进
steps	脚步
Steps	脚步
stereo	立体声
sterilised	消毒
stern	严肃
Steve	史蒂夫
Steven	史蒂芬
Stevens	史蒂文斯
Stevenson	史蒂文森
Stevie	史蒂维
stew	炖
stewardess	空中小姐
stick	棒
Stick	棒
sticker	贴纸
stickin	朵朵
sticking	症结
sticks	枝
sticky	黏
Sticky	黏
still	仍然
Still	仍然
stilts	高跷
Stilts	高跷
sting	刺
Sting	刺
stingy	小气
stink	臭
stinks	臭
stinky	臭
stir	搅拌
Stir	搅拌
stitches	针
stock	股票
stocked	库存
stockings	丝袜
stole	偷了
stolen	被盗
stomach	胃
stomped	跺着脚
stomping	跺脚
stood	站在
Stood	站在
stop	停
Stop	停止
STOP	停
stopped	停止
Stopped	停止
stopping	停止
stops	停止
storage	存储
store	商店
stores	商店
stories	故事
storm	风暴
Storm	风暴
story	故事
Story	故事
straddling	跨界
strafing	扫射
straigh	直行
straight	直行
straighten	弄直
straightened	拉直
strained	紧张
strange	奇怪
stranger	陌生人
strangers	陌生人
strap	背带
strappy	系带
street	街
Street	街
streets	街道
strength	强度
strengths	优势
stress	强调
stressed	强调
Stretching	拉伸
stretchy	有弹性
Stretchy	有弹性
strewn	撒满
strict	严格
strictly	严格
strike	罢工
string	串
strings	字符串
strip	跳闸
Strip	跳闸
stripped	剥离
stripper	脱衣舞
strippers	脱衣舞
Stripping	剥
strips	带子
stroke	行程
stroller	童车
strong	强大
stronger	强
strongest	最强
strongly	非常
struck	来袭
structure	结构体
struggle	斗争
struggling	奋斗的
Stu	斯图
stub	存根
stuck	卡住
Stuck	卡住
student	学生
students	学生们
studied	研究
study	研究
stuff	东西
Stuff	东西
stuffed	填充的
stuffer	填塞
stuffers	灌肠机
stuffing	馅
stumble	绊倒
stumped	难倒
stung	刺痛
Stung	刺痛
stunk	发臭
stunning	令人惊叹
Stunning	令人惊叹
stunted	发育不良
stupid	笨
Stupid	笨
stupidest	愚蠢的
stupidly	愣神
sturdier	坚固
Sturdy	粗壮
style	样式
styles	款式
stylish	时尚
Su	苏
subconscious	潜意识
subject	学科
subletting	转租
submarines	潜艇
submaring	潜艇
substances	物质
substantial	大量的
substitute	替代
subtitles	字幕
subtle	微妙
suburbs	郊区
subway	地铁
success	成功
successful	成功
such	这样
Such	这样
suck	吮吸
Suck	吮吸
sucked	吸
suckin	来吸
sucking	吸吮
suckle	哺乳
sucks	吸
sucky	苏茨基
sudden	突然
Sudden	突然
suddenly	突然
Suddenly	突然
suds	泡沫
suffered	遭遇
suffering	痛苦
suffrage	选举权
sugar	糖
Sugar	糖
sugarless	无糖
suggest	建议
suggested	建议
suggesting	提示
suggestion	建议
suggestions	建议
suicide	自杀
Suicide	自杀
suing	起诉
suit	适合
suitcases	手提箱
suite	套房
suited	合适的
suites	套房
suits	西装
sulk	忧郁
sullies	玷污
summer	夏季
Summer	夏季
summertime	夏令
sun	太阳
sunburned	晒伤
Sunday	星期日
Sundays	周日
sung	盛
sunglasses	墨镜
sunk	沉没
Sunshine	阳光
super	超
Super	超
superficial	浅
superhero	超级英雄
superintendent	所长
superiors	上级
Superman	超人
supermarket	超级市场
supermodels	超级名模
supervisor	监
supper	晚餐
suppliers	供应商
supplies	耗材
support	支持
supporting	支持
supportive	支持
suppose	假设
supposed	应该
Supposed	应该
supposedly	按说
supremely	千钧
sure	当然
Sure	当然
surface	表面
surgeon	外科医生
surgeons	外科医生
surgery	手术
surgically	手术
surprise	惊
Surprise	惊
surprised	诧异
surprisingly	出奇
surreal	超现实主义
surrogate	代孕
surrounded	包围
survive	生存
survived	幸存
survivor	幸存者
Susan	苏珊
Susans	舒尚
sushi	寿司
Susie	苏西
suspect	疑似
suspected	嫌疑
suspicion	怀疑
suspicious	可疑
swallow	吞
swallowed	吞食
swallowing	吞咽
swam	游
swans	天鹅
swap	交换
swear	发誓
swearing	宣誓就职
sweat	汗
sweater	毛线衣
sweaters	毛衣
sweating	出汗
sweats	盗汗
sweatshirt	运动衫
sweatshop	血汗工厂
sweaty	出汗
Swedish	瑞典
sweep	扫
Sweep	扫
sweeper	清扫车
sweeping	笼统的
sweet	甜
Sweet	甜
sweeter	更甜
sweetest	甜蜜
sweetheart	爱人
Sweetheart	爱人
sweetie	糖果
Sweetie	糖果
sweetpea	甜豆
Sweety	甜
swell	胀
swelling	肿胀
swift	迅速
swill	泔水
swim	游泳
Swim	游泳
swimmer	游泳者
swimmers	游泳
swimming	游泳的
swims	游泳
swing	摇摆
swinging	摆荡
Swinging	摆荡
swings	波动
swirl	漩涡
Swiss	瑞士人
switch	开关
Switch	开关
switched	交换的
switching	交换
Switzerland	瑞士
swollen	肿
swoop	落下
sword	剑
swordfish	旗鱼
swore	发誓
sycophant	拍马屁的人
syllable	音节
Sylvia	西尔维亚
symbol	符号
symbolic	象征
sympathetic	有同情心
syndrome	综合征
synthetic	合成的
syphilis	梅毒
syrup	糖浆
system	系统
systems	系统
Systems	系统
Szechwan	四川
Ta	钽
tab	标签
table	表
tablecloth	桌布
tables	表
tablespoon	汤匙
tacked	上涨
Tackled	解决
tackles	铲球
tackling	抢断
Tacks	鞋钉
tacky	俗气的
Taco	塔克
tad	点点
taffy	太妃糖
tag	标签
tagged	标记
Tah	塔赫
tail	尾巴
tailor	裁缝
tailpipe	排气管
tails	尾巴
Tails	尾巴
tainted	污点
Taj	泰姬陵
take	采取
Take	采取
taken	采取
takes	需要
Takes	需要
takin	羚牛
Takin	羚牛
taking	服用
Taking	以
Tale	故事
talent	天赋
Talent	天赋
talented	天才
talentless	无能
talk	谈论
Talk	谈论
talked	谈
talker	健谈
talkin	说话
talking	说
Talking	说
talks	会谈
talky	对讲机
tall	高
taller	高
tallies	吻合
tamer	驯
Tampa	坦帕
tampons	棉球
Tango	探戈舞
tank	罐
Tank	罐
tanked	喝醉的
tanned	鞣
Tanya	蔡健雅
tap	龙头
tape	胶带
taped	录音
tapes	磁带
tarp	篷布
Tarragon	龙蒿
Tart	酸
tartlet	馅饼
tartlets	馅饼
Tartlets	馅饼
Tarzan	泰山
task	任务
taste	味道
Taste	味道
tasted	尝
tasteful	品味
tastes	口味
tasting	品尝
tasty	可口
Tasty	可口
tat	达
tater	塔特
tattoo	黥
tattooed	纹身
tattoos	纹身
taught	教
taunting	辱骂
tax	税
taxes	税
taxi	出租车
Taxi	出租车
taxicab	出租车
tea	茶
Tea	茶
teach	教
teacher	老师
teaches	教
teachin	教材的目标
teaching	教学
team	球队
teamed	联手
teams	球队
tear	眼泪
tearing	撕裂
tears	眼泪
teased	戏弄
technical	技术
technicality	技术性
technically	技术上
Technically	技术上
technique	技术
Ted	摊晒
Teddy	泰迪熊
teen	青少年
Teen	青少年
teenage	青少年
teeny	蝇头
teeth	牙
Teflon	特富龙
tele	远程
telephone	电话
telescope	望远镜
television	电视
tell	告诉
Tell	告诉
teller	出纳员
tellin	泰兰
telling	告诉
tells	告诉
temp	温度
temple	寺庙
temporarily	暂时
temporary	临时
ten	十
Ten	十
tend	趋向
tended	往往
tendency	趋势
tender	投标
tenderness	压痛
tennis	网球
tenors	男高音
tense	紧张
tensed	紧张
tension	张力
tenth	第十
tepid	不温不火
tequila	龙舌兰酒
Tequila	龙舌兰酒
teramisu	提拉米苏
term	术语
terminal	终奌站
terms	条款
Terms	条款
terrace	阳台
terriably	可怕
terrible	可怕
Terribly	可怕
terriffic	了不起
terrific	了不起
Terrific	了不起
terrified	怔
territory	领土
terror	恐怖
terrorised	恐吓
Terry	特里
test	测试
testament	遗嘱
testing	测试
testosteroney	睾酮
tests	测试
testy	性急的
tetanus	破伤风
Texas	德州
textbook	教科书
th	日
Th	钍
Thai	泰国
than	比
thank	谢谢
Thank	谢谢
thanked	感谢
thankful	感谢
thanks	谢谢
Thanks	谢谢
Thanksgiving	感恩
Thanksgivings	感恩节
thankyou	谢谢
Tharp	撒普
that	那
That	那
THAT	那
thats	那是
Thats	那是
thatthat	那个那个
the	该
The	该
theater	剧院
Theater	剧院
theatre	剧院
Theatre	剧院
thee	你
their	其
Their	其
theirs	他们的
them	他们
Them	他们
theme	主题
themed	主题
themes	主题
themselves	他们自己
then	然后
Then	然后
Theodore	西奥多
theoretically	理论上
theories	理论
theory	理论
therapist	治疗师
therapy	治疗
there	那里
There	那里
therefore	因此
theres	有
Theres	有
Theresa	有个
thermos	热水瓶
these	这些
These	这些
they	他们
They	他们
theyre	他们是
Theyre	他们是
theyve	他们已经
thick	厚
thief	贼
thieves	盗贼
thieving	偷窃
thigh	大腿
thing	事情
Thing	事情
things	事
Things	事情
thingy	啄
think	认为
Think	认为
thinker	思想家
thinkin	想着
Thinkin	想着
thinking	思维
thinks	想
Thinks	想
thinner	更薄
thinnest	最薄
third	第三
Third	第三
thirsty	渴
thirteen	十三
thirty	三十
Thirty	三十
this	这个
This	这个
tho	寿
Tho	芹苴
Thomas	托马斯
thong	丁字裤
thorns	荆棘
thorough	彻底
those	那些
Those	那些
though	虽然
Though	虽然
thought	思想
Thought	思想
thoughtful	周到
thoughts	思念
thougtful	周到
thousand	千
thousands	数千
Thousands	成千上万
Thread	线
threat	威胁
threatened	受威胁
three	三
Three	三
threefold	三倍
threesome	三人组
Threesome	三人组
threshold	阈
threw	扔
thrilled	高兴
thro	救援人员到场
Thro	救援人员到场
throat	喉
throbbing	悸动
throne	王座
through	通过
throughout	始终
throw	扔
Throw	扔
throwing	投掷
thrown	抛出
throws	投
ths	部份
thud	轰的一声
thumb	拇指
thumbs	大拇指
Thurman	瑟曼
Thursday	星期四
thy	你的
Thy	你的
tiaras	皇冠
Tic	抽搐
tick	蜱
Tick	蜱
ticker	断续器
ticket	票
ticketed	票款
tickets	门票
Tickets	门票
ticking	滴答
tickling	发痒
tidying	整理
tie	领带
Tie	领带
tied	绑
tiered	分层
tiger	虎
tigers	老虎
tight	紧
Tiki	蒂基
til	胡麻
tile	瓦
tiles	瓷砖
till	直到
Till	直到
Tilly	蒂莉
tilt	倾斜
Tim	蒂姆
time	时间
Time	时间
timer	计时器
times	时
Times	时
timing	定时
Timothy	蒂莫西
tin	锡
Tina	蒂娜
Tinker	修补匠
tinkle	叮当声
tinsel	箔
tinted	有色
tiny	小
tip	小费
tipped	尖
tips	提示
tired	累
tissue	组织
Tissue	组织
tissues	组织
tit	山雀
Tit	山雀
Titanic	泰坦尼克号
title	标题
titling	所有权
to	至
To	至
toast	烤面包
Toblerone	三角巧克力
Toby	托比
today	今天
Today	今天
Todd	托德
toe	脚趾
Toe	脚趾
toenails	脚趾甲
toes	脚趾
together	一起
Together	一起
toilet	厕所
Toilet	厕所
toiletries	化妆品
Tokyo	东京
told	告诉
toll	收费
Tom	汤姆
tomato	番茄
tomatoes	番茄
Tomatoes	番茄
tomatos	番茄
Tommy	汤米
tomorrow	明天
Tomorrow	明天
ton	吨
tone	音
tones	音
tongue	舌
Tongue	舌
tongues	舌头
tonight	今晚
Tonight	今晚
tonnes	吨
tons	吨
tonsil	扁桃体
tonsils	扁桃体
Tony	托尼
too	太
Too	太
TOO	太
took	拿
Took	拿
tool	工具
tools	工具
tooth	齿
toothbrush	牙刷
toothless	无牙
tootsie	窈窕淑男
Tootsie	窈窕淑男
Tooty	小猫
top	最佳
topic	话题
topless	赤裸上身
tops	上衣
tore	撕毁
torn	撕裂
TorriniTorrini	的
tortilla	玉米饼
torture	拷打
toss	折腾
tot	合计
total	总
Total	总
totally	完全
Totally	完全
tots	切块
touch	触摸
touchdown	接地
Touchdown	接地
touchdowns	达阵
touched	感动
touches	触摸
touching	接触
touchy	易怒的
tough	强硬
Tough	强硬
toughest	最艰难的
toughie	恶棍
tounge	舌头
tour	游览
tourists	游客
Tourists	游客
touristy	旅游观光
tournament	比赛
Tova	娃
tow	拖
toward	往
towel	毛巾
towels	毛巾
town	镇
Town	镇
toy	玩具
toys	玩具
track	跟踪
tracked	追踪
tracks	轨道
Tracy	特雷西
trade	贸易
trading	贸易
tradition	传统
traditional	传统
traffic	交通
tragedy	悲剧
trail	落后
train	培养
trained	熟练
trainer	训练者
trainers	培训师
training	训练
trains	火车
trampled	践踏
trampoline	蹦床
tranquiliser	镇静剂
transaction	交易
transferred	转移
transferring	转移
Transit	过境
translated	翻译
translation	翻译
translator	翻译者
Translucent	半透明
transmission	传输
transmits	发送
transportation	运输
trap	陷阱
Trapp	特拉普
trapped	被困
trash	垃圾
trashed	丢弃
trashy	没用
traumatised	创伤
travel	旅行
Travel	旅行
Travelin	在旅行
Traveller	旅客
travelling	旅行
Travis	特拉维斯
tray	托盘
trays	盘
treasures	珍品
treat	对待
treated	治疗
treats	对待
tree	树
Treeger	倒真
trees	树木
Trees	树
Trek	跋涉
trembling	发抖
trench	沟
triangle	三角形
Trib	论坛报
Tribbiani	昂尼
Tribianni	昂尼
trick	特技
tricking	淋水
trickling	涓涓
tricks	技巧
tricky	狡猾
Trident	三叉戟
tried	试着
trigger	触发
trimester	三个月
trip	旅
Triple	三倍
triplets	三胞胎
tripped	跳闸
tripping	跳闸
troll	拖钓
trolls	巨魔
troop	部队
Troopers	战队
trophies	奖杯
trophy	杯
tropical	热带
trouble	麻烦
Trouble	麻烦
trousers	长裤
truck	卡车
true	真正
True	真正
truly	真
Trump	王牌
trust	信任
Trust	信任
trusted	信任
trusting	信任的
trusts	信托
truth	真相
try	尝试
Try	尝试
tryin	试着
trying	试
Trying	试
Tso	左宗棠
tub	桶
tube	管
tucked	藏
Tuesday	星期二
tulip	郁金香
tulips	郁金香
tummy	趴着
Tumour	瘤
tuna	金枪鱼
Tuna	金枪鱼
tunes	曲调
tunnel	隧道
turkey	火鸡
turkeys	火鸡
turn	转
Turn	转
turned	转身
Turned	转身
turnin	撇开
turning	车削
turns	圈
Turns	圈
turtle	龟
Turtle	龟
turtles	海龟
Tuscadero	塔斯卡德罗
tush	屁股
tutti	合奏
Tuttle	塔特尔
Tutu	楚楚
tux	晚礼服
TV	电视
tweezers	镊子
Tweezers	镊子
twelfth	第十二
twelve	十二
Twelve	十二
twentieth	第二十
twenty	二十
Twenty	二十
twice	两次
Twice	两次
twin	双胞胎
Twin	双胞胎
twinkie	小女生
twinkle	眨眼
twinkly	闪烁的
twins	双胞胎
twirly	惊慌
twist	捻
twisted	扭曲
Twister	倍捻机
two	二
Two	二
TWO	二
Tyler	泰勒
type	类型
typical	典型
typing	打字
typist	打字员
Tyrannosaurus	暴龙
ugh	啊
Ugh	啊
ugliest	最丑
ugly	丑陋
Ugly	丑陋
uh	呃
Uh	呃
uhh	嘘
Uhh	呃
uhhh	唔
Uhhh	唔
Uhhuh	嗯
Uhl	乌尔
uhm	嗯
Ukrainian	乌克兰
ultimate	最终
Ultimate	最终
ultimately	最终
ultrasonic	超声
Um	庵
Uma	乌玛
umbrella	雨伞
umm	乌姆
Umm	乌姆
ummm	嗯
Ummm	嗯
un	联合国
UN	联合国
unattainable	高不可攀
unattractive	没有吸引力
Unbearable	不堪忍受
unbelievable	难以置信的
Unbelievable	难以置信的
unbelievably	令人难以置信
unborn	腹中
Unbound	不作承诺
uncalled	多余
uncle	叔叔
Uncle	叔叔
unclench	松开紧握
unclog	疏通
unclogging	清通
uncomfortable	不舒服
unconscious	无意识
unconstituional	违宪
uncoordinated	不协调
under	下
Underdog	哀兵
undermine	破坏
underneath	下
underpants	内裤
Underpants	内裤
understand	了解
understanding	理解
Understanding	理解
understands	理解
understood	了解
understudy	替补
underwear	内衣
underwire	钢圈
undo	解开
Undone	未完成
undressed	脱了衣服
unemployed	失业的
uneven	不均匀的
unfair	不公平
unfaithful	不忠
unfinished	未完成
unflattering	直言不讳
unforgivable	不可饶恕
unfortunate	不幸的
unfortunately	不幸
Unfortunately	不幸
unfulfilling	不过瘾
unhappy	不快乐
unhooked	脱钩
uniform	制服
union	联盟
unit	单元
universal	普遍
universe	宇宙
unjustified	不合理
unless	除非
Unless	除非
unlike	不像
unlock	开锁
unnatural	不自然
unpack	解压
unplug	拔
unprecedented	史无前例
unprofessional	不专业
unpublished	未公布
unreasonable	不合理
unsaid	没说的
unscheduled	不定期
unsettling	惴惴
unsuccessful	不成功
unsupported	不支持
until	直到
Until	直到
untrusting	不信任
unusual	异常
unusually	异常
unyielding	不屈
up	向上
Up	向上
upbeat	乐观
updating	更新
upon	上
upset	烦乱
upside	上边
upstairs	楼上
Upstairs	楼上
upstate	北部
Upstate	北部
uptight	紧张
uptown	住宅区
ur	乌尔
urinate	溲
urn	瓮
Ursa	大熊
Ursula	乌苏拉
us	我们
Us	我们
US	我们
USA	美国
Usage	用法
use	使用
Use	使用
used	用过的
useless	无用
uses	使用
usher	招待员
ushers	招待员
usin	使用设
using	运用
usual	通常
usually	平时
Utah	犹他州
uterus	子宫
utterly	完全
Uuh	呜
vacated	腾空
vacuum	真空
vacuuming	吸尘
vagina	阴道
vague	模糊
vaguely	依稀
Vail	韦尔
vain	徒然
Valdez	瓦尔迪兹
Valente	瓦伦特
valentine	情人节
Valentine	情人节
valid	有效
valuable	有价值
van	面包车
Van	面包车
vandalism	人为破坏
vanilla	香草
Vanilla	香草
variety	品种
varnish	漆
varsity	队打
vascular	血管
vase	花瓶
Vase	花瓶
Vassar	瓦萨
Vatican	教廷
vault	拱顶
VCR	录像机
ve	已经
Vegas	拉斯维加斯
vegetable	蔬菜
vegetables	蔬菜
vegetarian	素
veil	面纱
veins	纹
Vell	贝尔
velociraptor	迅猛
Velvet	丝绒
Velveteen	平绒
vendor	供应商
Venezuela	委内瑞拉
vent	发泄
verbal	口头
verbs	动词
Vermont	佛蒙特
vernacular	白话
Veronica	维罗尼卡
Versachi	范思哲
verse	诗
version	版
versus	与
Vertigo	眩晕
very	非常
Very	非常
vessel	容器
vest	背心
vestibule	前厅
Vesuvius	维苏威
vet	兽医
veteranarian	兽医
vibe	盛传
vibrate	颤动
Vic	维克
vicariously	共鸣
vice	副
vicious	恶毒
victim	受害者
victims	受害者
Victor	胜利者
Victoria	维多利亚
Victorian	维多利亚时代
Vidal	维达尔
video	视频
videos	视频
viejo	别霍
Vietnam	越南
view	视图
views	意见
vigilante	私刑
viking	海盗
village	村
Village	村
villagers	村民
Vince	文斯
Vincent	文森特
vintage	酿酒
Vinyl	乙烯基
violated	违反
violation	违反
violence	暴力
violent	暴力
virgin	处女
Virginia	弗吉尼亚州
virginities	童贞
virginity	童贞
virility	性能力
virtual	虚拟
virtually	实质上
virus	病毒
Virus	病毒
Visa	签证
VISA	签证
viscously	粘滞
vision	视力
visit	访问
visitiing	访问
visits	访问
visually	视觉
Viva	欢呼声
Vivian	维维安
vividly	生动地
Vividly	生动地
Vivisection	活体解剖
Vlad	弗拉德
vodka	伏特加
voice	语音
volcano	火山
volcanoes	火山
Volkswagen	大众汽车
volleyball	排球
Volleyball	排球
voluntarily	自行
vomit	呕吐
vomiting	呕吐
von	冯
voted	投
Voted	投票
vowed	誓言
vowel	元音
vowels	元音
Voyage	航程
vu	似曾相识
vulcanised	硫化
vulnerability	漏洞
vulnerable	弱势
vulva	外阴
Vulva	外阴
vunerable	弱势
wack	怪人
wacky	古怪
waffle	胡扯
waffles	威化饼
wagering	投注
wagon	车皮
wah	华
Wah	华
waist	腰部
waistband	腰带
wait	等待
Wait	等待
waited	等待
waiter	服务员
waiters	服务员
waitin	倒底
waiting	等候
Waiting	等候
waitress	小姐
Waitress	小姐
waitresses	女服务员
waitressing	女服务生
Waitressing	女服务生
waitwait	等等
Waitwait	等等
wake	唤醒
Wake	唤醒
wakes	醒来
waking	醒来
walk	步行
walked	走
Walker	助步车
walkin	步入
walking	步行
Walking	步行
Walkman	随身听
walks	散步
Walks	自助游
wall	壁
Wall	壁
Wallace	华莱士
wallet	钱包
Wallpaper	墙纸
walls	墙壁
walnut	核桃
Waltham	沃尔瑟姆
Waltons	沃尔顿家族
wan	苍白
Wan	广域网
wandering	飘零
wanders	漫步
wank	手淫
want	想
Want	想
wanted	通缉
wanting	希望
wants	希望
Wants	希望
war	战争
War	战争
Warden	看守
wardrobe	衣柜
warm	暖
warming	变暖
warn	警告
warned	警告
warranty	保证
Warren	养兔场
Wars	战争
was	是
Was	是
wash	洗
Wash	洗
washboard	搓板
washed	洗
Washington	华盛顿
wasn''t	里面没有
waste	浪费
wasted	浪费
wasting	浪费
watch	看
Watch	看
watcha	沃彻
Watcha	沃彻
watched	看着
watches	手表
watchin	凝视着
watching	观看
water	水
Water	水
waterbed	水床
waterfalls	瀑布
watering	洒水
waters	水域
wave	波
Wave	波
waved	挥手
waving	挥手
wax	蜡
Wax	蜡
waxing	打蜡
way	办法
Way	办法
ways	方法
we	我们
We	我们
WE	我们
weak	弱
weapon	武器
weapons	武器
wear	穿
wearin	穿着
wearing	穿着
wears	穿
weasel	黄鼠狼
weather	天气
Weather	天气
weave	编织
web	卷筒纸
website	网站
wedded	结婚
wedding	婚礼
weddings	婚礼
Weddings	婚礼
wedgies	坡跟
Wednesday	星期三
wee	凌晨
Weebles	不倒翁
Weed	野草
week	周
weekend	周末
Weekend	周末
weekends	周末
weekly	每周
Weekly	每周
weeks	周
weenie	威尼
weenies	怪人
weep	泣
Weeper	爱哭鬼
weeping	泣
weighin	称量体重
weight	重量
weights	权重
weird	奇怪的
Weird	奇怪的
weirdest	最奇怪的
Welch	韦尔奇
welcome	欢迎
Welcome	欢迎
welder	焊机
well	好
Well	好
welling	夺眶而出
wells	井
Wells	韦尔斯
Wendy	温迪
went	去
Went	去
were	是
Were	是
west	西方
West	西方
Western	西
Westminster	威斯敏斯特
Westmont	威士茂
wet	湿
wetter	多雨
wetting	润湿
weve	我们已经
Weve	我们已经
Wh	瓦
wha	世界卫生大会
Wha	什
whack	重打
whacked	疲惫不堪
whaddya	那么
Whaddya	那么
whaling	捕鲸
wham	重打
Wham	重打
what	什么
What	什么
WHAT	什么
whatever	随你
Whatever	随你
whats	什么是
Whats	什么是
WhatsaWhatsApp	的
whatsoever	任何
Wheel	轮
wheels	车轮
when	什么时候
When	什么时候
whenever	每当
Whenever	每当
where	哪里
Where	哪里
wheres	哪里
Wheres	哪里
wherever	哪里
Wherever	哪里
whether	是否
whew	呼
Whew	呼
which	哪一个
Which	哪一个
Whichever	任何
whiff	喷气
while	而
While	而
whim	怪念头
whip	鞭子
Whip	鞭子
whipped	鞭打
Whipped	鞭打
whipping	鞭打
whiskey	威士忌酒
whispering	耳语
whistle	哨
Whistle	哨
white	白色
White	白色
whites	白人
Whitfield	惠特菲尔德
whiz	呼啸
who	谁
Who	谁
whoa	哇
Whoa	哇
WHOA	哇
whoah	哇
Whoah	哇
whoever	谁
Whoever	谁
whole	整个
wholesale	批发
whom	谁
whoo	喔
Whoo	喔
whooo	的
whoops	哎呦
Whoops	哎呦
whoosh	嗖
whore	妓女
whos	谁是
whose	谁的
Whose	谁的
why	为什么
Why	为什么
wi	无线
wicker	柳条
widow	寡妇
Widow	寡妇
widowed	寡
wieght	重量
wiener	维纳
wierd	奇怪
wife	妻子
Wife	妻子
wig	假发
wild	野生
Wild	野生
wildlife	野生动物
will	将
Will	将
Williamsburg	威廉斯堡
willing	愿意
win	赢得
wind	风
windmill	风车
window	窗口
WINDOW	窗口
windows	视窗
Windows	视窗
windshields	挡风玻璃
wine	葡萄酒
Wine	葡萄酒
Wineburg	温伯格
wing	翅膀
winged	翅
wings	翅膀
wink	眨眼
winked	眨眨眼睛
Winky	闪闪
winner	优胜者
Winner	优胜者
winning	胜利
Winona	薇诺娜
wins	胜
winter	冬季
Wintergarden	冬季花园
Winters	温特斯
Wipe	擦拭
wiped	抹
Wiper	雨刷
wire	线
wires	电线
wise	明智的
wish	希望
Wish	希望
wishes	祝福
wishing	希望
witch	巫婆
with	同
With	同
within	内
without	无
Without	没有
Witness	见证人
witnesses	目击者
wives	妻子
wizard	巫师
Wo	禾
woah	哇
Woah	哇
wobble	摇晃
woke	醒来
wolf	狼
wolverine	狼獾
Wolves	狼队
woman	女人
Woman	女人
womankind	世界女性
womb	子宫
women	妇女
Women	妇女
won	韩元
WON	韩元
wonder	奇迹
Wonder	奇迹
wondered	想知道
wonderful	精彩
Wonderful	精彩
wonderfully	奇妙
wondering	想知道
wonders	奇迹
wondrous	奇妙
wonerful	精彩
Wong	皇
Wont	惯于
woo	求爱
Woo	求爱
wood	木
wooden	木
woods	树木
woof	纬
Woof	纬
Wooh	呜
Wooo	的
woozy	喝醉的
word	字
Word	字
wordless	无言
words	话
wore	穿着
work	工作
Work	工作
worked	工作
worker	工人
workers	工作人员
workin	干活
working	工作的
workout	锻炼
works	作品
workshop	作坊
world	世界
World	世界
worlds	世界
worm	虫
Worm	虫
worms	蠕虫
worn	磨损的
worried	担心
worry	担心
worrying	令人担忧
worse	更差
Worse	更差
worship	崇拜
worst	最差
worth	价值
Worth	价值
would	将
Would	将
wouldnt	难道不
wound	伤口
wow	哇
Wow	哇
wrap	包裹
wrapped	包裹
wrapping	包皮
wraps	包装
wreaks	造成十分严重的
wreck	破坏
wrecked	失事
wrestling	摔角
wrinkly	皱
wrist	腕
write	写
writer	作家
writers	作家
writhing	扭动
writing	写作
written	书面
wrong	错误
Wrong	错误
wrote	写
wry	扭歪
wth	问心无愧
wuss	肉脚
Wuss	肉脚
Xerox	复印
ya	亚
Ya	雅
Yale	耶鲁
Yamaguchi	山口
yams	山药
Yankee	扬基
Yankees	洋基
yanking	唬弄
Yanni	雅尼
yard	码
yardstick	尺度
yarn	纱
yas	亚斯
Yasmine	亚斯曼
yaw	偏航
yay	好极了
Yay	好极了
ye	你们
Ye	叶
yea	是啊
Yea	是啊
yeah	是啊
Yeah	是啊
year	年
Year	年
yearbook	年鉴
yearbooks	年鉴
yearly	每年
years	年份
Years	年份
yeh	叶
yell	叫喊
yelled	大叫
Yeller	黄狗
yellin	喊
yelling	大呼小叫
yellow	黄色
Yemen	也门
yep	是的
Yep	是的
yes	是
Yes	是
YES	是
yesterday	昨天
yet	然而
Yikes	哎呀
y'killing	你笑死
y'know	你知道
Y'know	你知道吗
yo	哟
Yo	哟
yoga	瑜伽
yoghurt	酸奶
yogurt	酸奶
Yoko	洋子
York	纽约
you	您
You	您
YOU	您
young	年轻
Young	年轻
younger	更年轻
your	您的
Your	您的
youre	你是
Youre	你是
yours	你的
Yours	你的
yourself	你自己
yourselves	你自己
youself	你自己
youve	你已
Yu	宇
Yuh	裕
yuk	议员
yum	百胜
Yum	百胜
yumen	玉门
yummy	好吃
Yummy	好吃
Yup	对
Zachary	扎卡里
Zana	扎娜
zero	零
zexyzexy	的
Zilch	小人物
zillion	无数
zillionaire	兆亿富翁
Zima	泽玛
zine	杂志
Zinfandel	粉黛
zip	压缩
zipper	拉链
zone	区
zones	区
zoo	动物园
Zoo	动物园
zoom	放大
Zoom	放大
zoos	动物园
a	一个
A	一个
A.M.	上午
Aaah	啊哈
Aah	啊哈
Aahh	啊哈
a-as	一
aayah	节经文
aback	吓了一跳
Abbey	僧院
Abbott	雅培
ability	能力
able	能够
abnormality	异常
abnormally	异常
aboard	船上
Abott	雅培
about	关于
About	关于
above	以上
abruptly	突然
absence	缺席
absolute	绝对
absolutely	绝对
Absolutely	绝对
abuse	滥用
abyss	深渊
academy	学院
accelerating	加速
accent	口音
accept	接受
accessible	无障碍
accident	事故
accidentally	偶然
accompanies	相伴
accompany	陪
According	根据
account	帐户
accounts	账户
Ace	高手
achieved	实现
acoustical	声音
across	横过
act	法案
acting	演戏
action	行动
activity	活动
actor	演员
actors	演员
acts	行为
actual	实际
actually	其实
Actually	其实
acually	其实
ad	广告
Ad	广告
Adam	亚当
add	加
added	添加
adding	加入
additional	额外
address	地址
addressed	解决
addressing	解决
Adelman	阿德尔曼
Adidas	阿迪达斯
Adios	一路平安
adjoining	隔壁的
adjustment	调整
adjusts	调整
admirer	爱慕者
admires	佩服
admiring	欣赏
admissions	招生
admit	承认
admitting	承认
adopt	采用
adorable	可爱的
adore	崇拜
Adrienne	阿德里安娜
advance	预先
advantage	优点
advised	建议
aerosol	气雾剂
affection	感情
affectionately	深情
afford	给予
afghan	阿富汗
afraid	害怕
afro	黑人
after	后
After	后
afternoon	下午
afterthought	事后
Afterwards	然后
again	再次
Again	再次
against	反对
age	年龄
Age	年龄
aged	老
agency	机构
Agency	机构
agent	代理人
agents	代理
ago	前
agog	急切
agony	痛苦
agree	同意
agreed	同意
agreement	协议
agrees	同意
ah	啊
Ah	啊
ahead	先
ahem	啊哈
ahh	啊
Ahh	啊
Ahhh	唉唉
ai	嗳
aimlessly	等闲
air	空气
Air	空气
airline	航空公司
airplane	飞机
airport	飞机场
Airport	飞机场
aisle	走道
Al	人
Al.	人
Alan	艾伦
alarm	报警
Albany	奥尔巴尼
albino	白化病
album	专辑
alcohol	醇
alcove	壁龛
Algonquin	阿冈昆
Alice	爱丽丝
alimony	赡养费
alive	活
all	所有
All	所有
alley	胡同
allmost	的
allowed	允许
allows	允许
allways	永诺
almost	几乎
alone	单独
along	沿
along.	沿
aloud	高声
alphabet	字母
already	已经
alright	好的
Alright	好的
Alrightalrightalright	好吧好吧好吧
also	也
Also	也
altar	坛
altars	祭坛
alter	改变
altered	改变
alternative	替代
Althea	木槿花
although	虽然
Although	虽然
always	总是
am	上午
Am	上午
Amanda	阿曼达
amazed	吃惊
amazement	惊愕
amazing	惊人
Amazing	惊人
Amber	琥珀色
ambush	伏击
America	美国
American	美国
amigos	吾友
amongst	其中包括
amount	量
Amsterdam	阿姆斯特丹
amused	乐
amusing	有趣
an	一个
An	一个
Anchors	锚
Ancient	古
and	和
And	和
Andie	安迪
Andr	安德烈
Andrea	安德里亚
anecdotes	轶事
Angela	安吉拉
anger	愤怒
angered	激怒
angle	角度
angles	角
angrily	愤怒地
Angrily	愤怒地
angry	愤怒
Angry	愤怒
animal	动物
Animal	动物
animals	动物
animosity	敌意
ankle	踝
ankles	脚踝
Ann	安
Annabelle	安娜贝尔
Annie	安妮
announcement	公告
annoyed	懊恼
annoying	恼人的
Annoying	恼人的
annual	全年
another	另一个
Another	另一个
answer	回答
Answer	回答
answered	回答
answering	回答
Answering	回答
answers	答案
Answers	答案
ante	赌注
anthem	圣歌
anti-theft	防盗
ants	蚂蚁
anxiously	焦急地
any	任何
Any	任何
anybody	任何人
Anybody	任何人
anyhoo	安美居
Anyhoo	安美居
anymore	再
anyone	任何人
anything	什么
Anything	什么
anytime	随时
anyway	无论如何
Anyway	无论如何
anywhere	随地
Anywhere	随地
apart	距离
apartment	公寓
Apartment	公寓
apartments	公寓
Apartments	公寓
apologise	道歉
apologises	道歉
apologize	道歉
apologizing	道歉
apology	歉意
appalled	慑
apparent	明显的
apparently	显然地
Apparently	显然地
appear	出现
appears	出现
appetite	食欲
appetizers	开胃菜
applaud	鼓掌
applauds	叫好
applause	掌声
apple	苹果
apples	苹果
applying	应用
appointment	任命
appreciate	欣赏
appreciates	赞赏
appreciatively	感激地
apprehension	忧虑
approach	方法
approaches	方法
approaching	接近
Approaching	接近
approval	批准
approve	批准
approved	批准
approvingly	赞许地
apron	围裙
aptitude	资质
Aramis	阿拉米斯
are	是
Are	是
area	区域
argueing	认为
arguing	争论
argument	论点
arm	手臂
armful	可
armloads	一抱之量
arms	武器
army	军队
Arnold	阿诺德
aroma	香气
Aroma	香气
around	周围
arrested	逮捕了
arrival	到来
arrive	到达
arrived	到达
arrives	到达
arriving	到达
art	艺术
Art	艺术
artichoke	洋蓟
as	作为
As	作为
ASAP	尽快
ashamed	羞愧
aside	一边
ask	问
Ask	问
asked	问
Asked	问
askew	歪斜的
asking	问
asks	问
Asks	问
asleep	睡着了
aspirin	阿斯匹林
aspirins	阿司匹林
asprin	阿司匹林
ass	屁股
assassin	刺客
assembling	组装
asses	驴
assets	资产
assistant	助理
Assistant	助理
assume	假设
assuming	假设
asteroid	小行星
astonished	惊讶
astounded	震惊
astronaut	宇航员
at	在
At	在
ate	吃了
Athens	雅典
Atlanta	亚特兰大
Atlantic	大西洋
atlas	阿特拉斯
ATM	自动取款机
atmosphere	大气
atomic	原子
atrium	中庭
Atta	阿塔
attach	附加
attached	附加
attack	攻击
attacked	攻击
attacking	攻击
attacks	攻击
attempt	尝试
attempting	尝试
attempts	尝试
attendant	服务员
attended	参加了
attention	注意
attract	吸引
attracted	吸引了
attracting	吸引
attractive	有吸引力的
audience	观众
audio	音频
audition	试镜
auditioned	试镜
Auditorium	礼堂
Aunt	阿姨
Aurora	极光
authentic	真实的
Authority	权威
automatically	自动
Automatically	自动
available	可用
avec	与
Avenue	大道
aver	断言
average	平均
avert	避免
avoid	避免
avoiding	避免
Aw	亚历山大
awaiting	等待
awake	醒着的
awaken	唤醒
awakening	觉醒
awakens	唤醒
away	走了
a-way	的一种方式
awful	可怕的
Awful	可怕的
awfully	非常
awhile	一段时间
awkward	尴尬的
Awkward	尴尬的
awkwardly	尴尬的
Awkwardly	尴尬的
awoken	醒来
aww	哇哇哇
Aww	哇哇哇
Awww	哇
Awwwww	名叫
Axel	阿克塞尔
Aye	啊
B.F.F.	有关
baaad	很糟糕
babbling	呀呀学语
babe	宝贝
babies	婴儿
baby	婴儿
Baby	婴儿
babysitting	保姆
bachelor	本科
Bachelor	本科
back	回来
Back	回来
BACK	回来
backfired	事与愿违
background	背景
backing	支持
backpack	背包
backs	支持
Backstage	后台
backswing	回复
backup	备份
backward	落后的
backwards	向后
backyard	后院
bad	坏
Bad	坏
badda	巴达
baddest	最坏的
baddie	反派角色
badly	严重
bag	袋
bagels	百吉饼
bags	袋
bah	呸
bail	保释
bake	烤
Bake	烤
baked	烤
Bakery	面包店
balance	平衡
balanced	平衡
balcony	阳台
Balcony	阳台
bald	秃头
ball	球
balled	粗心大意
balloon	气球
balloons	气球
ballpark	球场
Bang	爆炸
banging	敲
bangs	刘海
Bangs	刘海
bank	银行
Banner	横幅
banquet	宴会
bar	酒吧
Barbara	芭芭拉
barbecue	烧烤
barbershop	理发店
Barbi	芭比
Barcelona	巴塞罗那
bare	裸露的
barely	几乎没有
Barely	几乎没有
Baring	霸菱
bark	树皮
barking	吠叫
barks	叫
barnyard	下流的
Barr	巴尔
Barry	巴里
bars	酒吧
bartender	酒保
base	基地
baseball	棒球
based	基于
basement	地下室
bashing	抨击
basic	基本
basically	基本上
Basically	基本上
basket	篮子
basketball	篮球
baskets	球鞋
bastard	混蛋
bat	蝙蝠
bath	浴
bathing	洗澡
bathrobe	浴袍
bathrobes	浴袍
bathroom	浴室
Bathroom	浴室
bathtub	浴缸
battery	电池
bay	湾
Bay	湾
Baywatch	贝手表
be	是
Be	是
Bea	东亚银行
beach	海滩
Beach	海滩
beam	梁
beams	梁
bean	豆
beans	豆子
Beans	豆子
bear	熊
Bear	熊
bearings	轴承
bears	熊
beat	击败
BEAT	击败
beating	打
Beatrice	比阿特丽斯
Beatty	比提
beautiful	美丽的
Beautiful	美丽的
beauty	美
Beavis	导演
because	因为
Because	因为
Becker	贝克尔
become	成为
becomes	就变成了
becoming	成为
becuase	因为
bed	床上
bedding	床上用品
bedroom	卧室
Bedroom	卧室
bedrooms	卧室
been	被
beep	哔哔的声音
beeped	哔哔作响
beeper	蜂鸣器
beeping	哔哔
beer	啤酒
Beer	啤酒
beers	啤酒
before	之前
Before	之前
begin	开始
begins	开始
behalf	代表
behaviour	行为
behind	后面
Behind	后面
bein	傻
being	被
Being	被
belief	信仰
believe	相信
Believe	相信
believed	相信
belive	相信
bell	贝尔
Bell	贝尔
bellied	大肚子的
belligerently	好斗地
bells	钟
belly	肚子
belongings	物品
belongs	属于
below	下面
belt	带
bemused	困惑的
Ben	本
bench	板凳上
bend	弯曲
bending	弯曲
bends	弯曲
Bends	弯曲
beneath	下
Benny	本尼
bent	弯曲
be-okay	没事的
Bernice	柏妮丝
beside	旁边
besides	除了
best	请接受我最美好的祝愿
Best	请接受我最美好的祝愿
bet	打赌
betcha	我打赌
Beth	贝丝
betray	背叛
betrayal	背叛
better	更好的
Better	更好的
Betty	贝蒂
between	之间的
Between	之间的
bha	底部钻具组合
biblical	圣经
bickering	争吵
big	大
Big	大
bigger	更大的
biggest	最大的
Bijan	毕扬
bike	自行车
bikini	比基尼
bill	比尔
Billions	数十亿
Billy	比利
bing	必应
Bing	必应
binoculars	双筒望远镜
bird	鸟
Bird	鸟
BIRDIE	小鸟
birds	鸟
Birds	鸟
birth	出生
birthday	生日
Birthday	生日
births	出生
bisexuals	双性恋者
bit	位
bitch	婊子
BITCH	婊子
bitched	抱怨
bite	咬
bites	咬
bits	位
bitten	咬
bitterest	痛苦的
black	黑色的
Black	黑色的
blackberry	黑莓
Blackberry	黑莓
blackboard	黑板上
blackout	停电
Blackout	停电
blade	叶片
Blades	叶片
blah	废话
Blah	废话
blame	怪
blank	空白
blanket	毯子
blankets	毯子
blankly	茫然地
blanks	空白
Blast	爆炸
blazed	开辟
blazers	开拓者
ble	祝福
bleed	流血
blender	搅拌机
blew	吹
blind	盲目的
blinds	百叶窗
blink	眨眼
blinking	闪烁的
blocked	阻塞
blocks	块
blond	金发碧眼的
blonde	金发女郎
Bloomingdale	卢明
blouse	上衣
blow	打击
Blow	打击
blower	鼓风机
blowing	吹
blown	吹
blows	吹
blue	蓝色的
Blue	蓝色的
bluebells	蓝铃花
bluffing	虚张声势
Bo	薄
board	董事会
boarding	登机
boards	董事会
boat	船
bob	鲍勃
Bob	鲍勃
bobbing	摆动
Bobby	鲍比
bobs	短发
bodies	的身体
body	身体
Boggle	犹豫
boil	煮
boles	博尔斯监管的
bologna	博洛尼亚
bolt	螺栓
bolts	螺栓
bombardment	轰炸
Bon	好的
bond	债券
bone	骨
bones	骨头
bong	锣
bongs	声音
bonus	奖金
boob	女人的乳房
boobie	芭比
boobs	乳房
book	书
Bookbinder	装订商
Bookbinders	图书装订商
bookcase	书柜
booked	订了
books	书
boom	繁荣
booms	繁荣
booth	展位
booths	展位
boots	靴子
booze	酒
bored	无聊
boring	无聊的
born	出生
borrow	借
borrowed	借来的
bosom	胸部
boss	老板
both	这两个
Both	这两个
bother	麻烦
bothers	困扰
bottle	瓶
Bottle	瓶
bottles	瓶
bottom	底
bouche	嘴
bought	买了
bounce	反弹
bounces	反弹
bouncing	跳跃
bound	绑定
bouquet	花束
bout	端
Boutros	加利
bow	弓
Bowe	鲍
bowl	碗
box	盒子
Box	盒子
boxer	拳击手
boxers	拳击手
boxes	盒子
boxing	拳击
Boxing	拳击
boy	男孩
Boy	男孩
boyfriend	的男朋友
boyish	孩子气的
boys	男孩
bra	胸罩
bracelet	手镯
brag	吹牛
brain	大脑
Brake	刹车
brakes	刹车
braking	制动
brand	品牌
bras	手臂
Bras	手臂
brave	勇敢的
bread	面包
break	打破
Break	打破
BREAK	打破
breakfast	早餐
Breakfast	早餐
breaking	打破
breaks	休息时间
Breaks	休息时间
breakup	分手
breast	乳房
breasts	乳房
breath	呼吸
breathe	呼吸
Breathe	呼吸
breathing	呼吸
breezy	活泼的
Brian	布莱恩
bribery	贿赂
bridal	新娘
Bridal	新娘
bride	新娘
Bride	新娘
bridesmaid	伴娘
bridesmaids	伴娘
bridge	桥
Bridge	桥
brief	短暂的
briefcase	公文包
briefly	短暂的
bright	明亮的
brighten	照亮
brightens	照亮
brightly	明亮
brim	边缘
bring	带
Bring	带
bringing	把
brings	带来了
Brings	带来了
British	英国
Brits	英国人
broadcast	广播
Broadway	百老汇
broke	打破了
broken	破碎的
Broken	破碎的
broom	扫帚
broth	肉汤
brother	哥哥
brought	带来了
brow	眉毛
brown	布朗
Brown	布朗
brownie	巧克力蛋糕
brownies	布朗尼
browsing	浏览
Bruce	布鲁斯
bruised	瘀伤
brunch	早午餐
brunette	浅黑肤色的女人
brush	刷
brushes	刷
brushing	刷牙
brutal	残酷的
bubble	泡沫
bubbles	泡沫
Buchman	布赫曼
buck	巴克
bucket	桶
Buckingham	白金汉
buckles	扣
bucko	欺凌弱小者
bucks	雄鹿队
bud	芽
buddy	好友
budge	让步
buds	味蕾
buffet	自助餐
bug	错误
bugger	同性恋者
bugs	错误
Bugs	错误
building	建筑
buildings	建筑
builds	构建
built	建
bulge	胀
bullies	恶霸
bulls	公牛队
bully	欺负
Bummer	游手好闲的人
bump	撞
bumped	撞
bumper	保险杠
bumping	碰撞
bumps	疙瘩
Bumpy	崎岖不平的
bunch	群
Bunch	群
bunched	形成一串
bunnies	小兔子
bunny	兔子
Bunny	兔子
buns	面包
burg	伯格
burger	汉堡
burgers	汉堡
burgundy	勃艮第
buried	埋
buries	埋葬
Buries	埋葬
Burke	伯克
burly	身材魁梧的
burn	燃烧
Burn	燃烧
burned	燃烧
burnin	燃烧
burns	伯恩斯
burnt	烧
burst	破裂
Burst	破裂
bursts	爆发
bus	公共汽车
business	业务
businesslike	有条理的
busted	被降级的
busy	忙
but	但
But	但
butcher	屠夫
butcome	但是一旦
butt	屁股
butter	黄油
Butterscotch	奶油糖果
button	按钮
buttons	按钮
butts	屁股
buy	买
Buy	买
buying	购买
buzz	嗡嗡声
buzzed	发出嗡嗡声
buzzer	蜂鸣器
buzzes	热闹
by	通过
By	通过
BY	通过
bye	再见
Bye	再见
cab	出租车
cabin	小屋
cabinet	内阁
cabinets	橱柜
cable	电缆
cabs	出租车
cafe	咖啡馆
cafeteria	自助餐厅
cage	笼子里
cages	笼子里
cake	蛋糕
Cake	蛋糕
cakes	蛋糕
cakey	凝固了的
calculator	计算器
call	叫
Call	调用
called	被称为
caller	调用者
Caller	调用者
callin	呼入
calling	调用
Calling	调用
calls	调用
Calls	调用
calm	平静
Calm	平静
calming	平静的
calmly	平静地
calms	平静下来
Calvin	卡尔文
came	来了
camera	相机
Camera	相机
Camomile	甘菊
camp	营
can	可以
Can	可以
cancel	取消
cancer	癌症
candle	蜡烛
candles	蜡烛
candy	糖果
canna	美人蕉
canoe	独木舟
cans	罐
capable	有能力
capacity	能力
capital	资本
Capital	资本
Cappuccino	卡布奇诺咖啡
cappucino	卡布其诺
caps	帽
captain	队长
car	车
Car	车
card	卡
cardboard	纸板
cardigan	开襟羊毛衫
cards	卡片
care	护理
career	职业生涯
careers	职业生涯
Careful	小心
carefully	小心翼翼地
cares	在乎
caresses	爱抚
Carl	卡尔
carnivore	食肉动物
Carol	卡罗
Carols	颂歌
carpet	地毯
carries	携带
carry	携带
Carry	携带
carrying	携带
carryon	可以随身携带的
cart	车
carton	纸箱
cartons	纸箱
cartoon	卡通
cartwheel	车轮
carved	雕刻
case	情况下
cases	情况下
Casey	凯西
cash	现金
cassette	盒式磁带
cast	投
castle	城堡
casts	数据类型转换
casually	随便
cat	猫
Cat	猫
catalogue	目录
cataract	白内障
catch	抓
Catch	抓
catches	捕获
catching	捕捉
categories	类别
category	类别
cater	满足
caterer	承办酒席的人
caterers	酒店老板
Catholic	天主教
cats	猫
Cats	猫
caught	抓住了
cause	导致
'cause	因为
Cause	导致
causes	原因
causing	导致
cautiously	小心翼翼地
ce	这个
ceiling	天花板
ceilings	天花板
celebrate	庆祝
celebrates	庆祝
celebrating	庆祝
celebration	庆祝活动
cell	细胞
cellar	地窖
cellular	细胞
Celtics	凯尔特人
center	中心
Center	中心
Central	中央
centre	中心
cents	美分
ceramic	陶瓷
cereal	麦片
certain	某些
certainly	当然
cervix	子宫颈
cha	查
Cha	查
chain	链
chained	链接
chair	椅子
chairs	椅子
challenge	挑战
champagne	香槟
Champion	冠军
championship	冠军
Championship	冠军
champs	字段
Chan	陈
chance	机会
chances	机会
Chand	集
Chandler	钱德勒
Chandlers	钱德夫妇
change	改变
Change	改变
changed	改变了
changer	改变
changes	变化
changing	改变
channel	通道
Channel	通道
Chanukah	光明节
Chanukah.	光明节
Chap	章
chapel	教堂
charact	生产
character	字符
characters	字符
charcoal	木炭
charity	慈善机构
Charlton	查尔顿
charm	魅力
charming	迷人的
charms	魅力
charred	烧焦的
chart	图表
chase	追逐
chased	追逐
chases	追逐
Chases	追逐
chasing	追逐
chat	猫
chatting	聊天
cheap	便宜的
cheat	作弊
cheating	作弊
check	检查
Check	检查
checkbook	支票簿
checked	检查
checkin	签入
checking	检查
checks	检查
Checks	检查
cheddar	切达干酪
cheek	脸颊
cheer	欢呼
Cheerfully	高高兴兴地
cheerfulness	快乐
cheerleader	啦啦队长
cheerleading	啦啦队
cheers	干杯
Cheers	干杯
cheery	愉快的
cheese	奶酪
Cheese	奶酪
cheesy	干酪
Cheeto	芝士
chef	厨师
Chef	厨师
chefs	元首
Chelsea	切尔西
chemical	化学
cherries	樱桃
chest	胸部
chestnuts	栗子
chewing	咀嚼
chez	家里
chi	气
Chicago	芝加哥
chick	小鸡
chicken	鸡
Chicken	鸡
chickens	鸡
chicks	小鸡
chicky	粗糙
chiefs	首领
child	孩子
childhood	童年
childish	幼稚的
childishly	幼稚地
children	孩子们
chill	寒冷
chime	敲出和谐的声音
chin	下巴
China	中国
Chinese	中国人
chip	芯片
Chip	芯片
chipper	削片机
chips	芯片
chiropractor	脊椎指压治疗者
chirping	鸣叫
Chloe	克洛伊
chocolate	巧克力
chocolatey	巧克力色
choice	选择
choices	选择
choke	窒息
choked	窒息
choking	令人窒息的
choose	选择
chooses	选择
chop	切
chopped	切碎
chopping	切
chopsticks	筷子
chord	和弦
chords	和弦
chorus	合唱
chose	东西
chou	卷心菜
Chris	克里斯
christening	洗礼仪式
Christine	克里斯汀
Christmas	圣诞节
chubby	胖乎乎的
chuckle	咯咯的笑
chuckles	笑着说
Chuckles	笑着说
chuckling	呵呵
chucks	轻叩
church	教堂
chute	垮台
cider	苹果酒
cigar	雪茄
cigarette	香烟
Cigarette	香烟
cigarettes	香烟
Cigarettes	香烟
cigars	雪茄
Cincinnati	辛辛那提
cinnamon	肉桂
Cinnamon	肉桂
circle	圆
circles	圈
Circus	马戏团
Citizen	公民
city	城市
City	城市
civil	民事
Civil	民事
clad	复合
clambers	艰难爬
clapping	鼓掌
claps	鼓掌
clarity	清晰
Clark	克拉克
clasping	抱茎
class	类
classes	类
classic	经典
Classroom	教室
Claude	克劳德
Claus	老人
Clause	条款
claws	爪子
clean	清洁
cleaned	清洗
cleaners	清洁工
cleaning	清洁
clear	清晰的
Clear	清晰的
clearly	很明显
Clearly	很明显
clears	清除
cleavage	分裂
clenches	紧
clerk	职员
click	点击
clicking	点击
clicks	点击
client	客户端
cliffhanger	扣人心弦的比赛
climb	爬
climbed	爬上
climbing	攀爬
climbs	爬
cling	抓住
clinic	诊所
Clinic	诊所
clink	发出叮当声
clinking	无比的
clinks	发出叮当声
Clint	克林特
clip	剪辑
clipboard	剪贴板
clips	剪辑
clock	时钟
Clockwork	发条
clogged	堵塞
close	关闭
Close	关闭
closed	关闭
Closed	关闭
closely	密切
closer	更紧密的
closes	关闭
Closes	关闭
closet	衣橱
closing	关闭
Closing	关闭
closure	关闭
Closure	关闭
closures	闭包
cloth	布
clothes	衣服
clowns	小丑
club	俱乐部
clubbing	泡吧
clubs	俱乐部
clue	线索
clutch	离合器
clutches	离合器
clutching	抓着
coaches	教练
coaching	训练
coal	煤炭
coast	海岸
coat	外套
coats	外套
cocking	竖起
cockpit	驾驶舱
cocoa	可可
code	代码
coffee	咖啡
Coffee	咖啡
coffees	咖啡
coin	硬币
coins	硬币
Coke	可口可乐
cold	冷
coldly	冷冷地
Colin	科林
coliseum	竞技场
collapse	崩溃
collapses	崩溃
collect	收集
collection	集合
collects	收集
college	大学
cologne	科隆
Colonel	上校
color	颜色
colored	彩色的
colorful	色彩斑斓的
coloring	着色
colours	颜色
coma	昏迷
Coma	昏迷
combination	结合
come	来
Come	来
comedy	喜剧
comes	来了
Comes	来了
comfort	安慰
comfortable	舒适的
comforting	令人欣慰的
comforts	舒适
comics	漫画
comin	科明
coming	未来
Coming	未来
command	命令
comment	如何
commercial	商业
Commercial	商业
Commerical	商业
commitment	承诺
committee	委员会
committing	提交
communicating	沟通
companies	公司
company	公司
compare	比较
compared	相比
compass	指南针
complain	抱怨
complaining	抱怨
complementary	互补
complements	补充
complete	完整的
completely	完全
Completely	完全
complies	符合
comprehends	理解
Computech	博
computer	电脑
concentrate	集中注意力
concept	概念
concern	关注
concerned	有关
concerns	担忧
concert	音乐会
concluded	得出的结论
conclusion	结论
condescendingly	谦逊地
condition	条件
condoms	避孕套
cone	锥
confer	授予
conference	会议
confetti	五彩纸屑
confident	自信
confidently	自信地
confirmed	确认
confronted	面对
confronting	面对
confronts	面对
confused	困惑
Confused	困惑
congratulate	祝贺
congratulates	祝贺
congratulation	祝贺
congratulations	祝贺你
Congratulations	祝贺
consent	同意
consider	考虑
considered	被认为是
considers	认为
Considers	认为
consolation	安慰
console	控制台
consoling	安慰
constantly	不断地
consults	咨询
consummated	完成
consummating	完善
contact	联系
Contact	联系
container	容器
containers	容器
containing	包含
contains	包含
contemplate	考虑
contents	内容
contest	比赛
continue	继续
continued	继续
Continued	继续
continues	仍在继续
continuing	继续
Continuing	继续
continuously	不断
contract	合同
control	控制
Control	控制
controls	控制
conventional	传统的
conversation	谈话
convey	传达
convinced	相信
convincing	令人信服的
cook	库克
cookie	饼干
Cookie	饼干
cookies	饼干
cooking	烹饪
Cooking	烹饪
cool	很酷的
Cool	很酷的
cooler	冷却器
co-operating	合作
cooperation	合作
copied	复制
copier	复制
cops	警察
copy	复制
cord	绳
cordless	无线
cork	软木塞
corn	玉米
corner	角落里
corners	角落
corporation	公司
corpses	尸体
correct	正确的
correctly	正确
corridor	走廊
corsage	胸衣
co-star	联合主演
costume	服装
cotton	棉花
couch	沙发上
coucher	睡觉
couches	尿布
cough	咳嗽
coughing	咳嗽
coughs	咳嗽
Coughs	咳嗽
could	可以
Could	可以
couldn't	不能
counselor	辅导员
count	数
Count	数
countdown	倒计时
counte	女伯爵
counter	计数器
counters	计数器
counting	计数
country	国家
coupla	几个
couple	夫妇
couples	夫妻
coupon	优惠券
coupons	优惠券
courage	勇气
course	课程
courtside	场边
cover	封面
covered	覆盖
covering	覆盖
covers	涵盖了
Covers	涵盖了
cow	牛
cowboy	牛仔
Cowboys	牛仔
co-worker	同事
co-workers	同事
cows	牛
coy	腼腆的
crab	蟹
Crabby	易怒的
crack	裂纹
cracker	饼干
cracking	破解
cracks	裂缝
cradled	抱着女孩
craftsmanship	工艺
cramp	抽筋
Cramp	抽筋
cranberry	蔓越莓
Crane	起重机
cranial	颅
cranky	脾气暴躁
crap	废话
crap.	废话
crapping	拉屎
crash	崩溃
crashed	坠毁
crashes	崩溃
craving	渴望
crawl	爬
crawls	爬
craziest	疯狂
crazy	疯狂的
Crazy	疯狂的
creak	嘎吱嘎吱声
creaking	摇摇欲坠
creaks	吱吱的响声
cream	奶油
crease	折痕
create	创建
creating	创建
creation	创建
creature	生物
credit	信贷
credited	认为
creep	蠕变
creepers	爬行物
creeping	爬
Crew	机组人员
crib	婴儿床
cried	哭了
cries	哭
crisis	危机
criss	纵纵横
croissant	新月
cross	交叉
Cross	交叉
crossed	交叉
crosses	十字架
crossing	穿越
crossword	填字游戏
crouches	蹲
crowd	人群
crowded	拥挤的
crowing	啼叫
crows	乌鸦
cruel	残酷的
crumb	面包屑
crumbles	弄碎
crumbs	面包屑
crumpes	发嘎吱嘎吱声
crumples	起皱
crunches	仰卧起坐
crush	粉碎
crushes	压碎
crust	地壳
cry	哭
crying	哭
Crystal	水晶
cubby	小房间
cube	多维数据集
cubicle	小隔间
cuddled	拥抱
cuddlily	可爱的
cuddling	拥抱
cue	提示
cup	杯
cupboard	橱柜
Cupid	丘比特
cups	杯
curb	抑制
current	当前的
curry	咖喱
cursed	被诅咒的
curtain	窗帘
curve	曲线
cushion	缓冲
cushions	垫子
customer	客户
customers	客户
customs	海关
cut	减少
Cut	减少
cute	可爱的
cuter	可爱的
cuts	削减
cutting	切割
dad	爸爸
Dad	爸爸
daddy	爸爸
Daddy	爸爸
dads	爸爸
daft	愚蠢的
Dah	哒
daily	每天
daiquiris	得其利
dairy	乳制品
damage	损害
dammit	该死的
Dammit	该死的
damn	该死
Damn	该死的
damnit	该死的
Damnit	该死的
Dan	丹
dance	跳舞
danced	跳舞
dancer	舞者
dances	舞蹈
dancing	跳舞
Dancing	跳舞
dangling	晃来晃去的
Danielle	丹尼尔
dare	敢
daring	大胆的
dark	黑暗
Dark	黑暗
darkened	黑暗的
darling	亲爱的
Darling	亲爱的
darn	该死的
Darn	该死的
dart	飞镖
Dartmouth	达特茅斯
darts	飞镖
Daryl	达里尔
dash	破折号
data	数据
date	日期
Date	日期
dates	日期
dating	约会
daughter	女儿
Dave	戴夫
David	大卫
Davis	戴维斯
day	一天
Day	一天
DAY	一天
days	天
Days	天
daytime	白天
dead	死
Dead	死
deadline	的最后期限
deadpan	面无表情
deal	交易
Deal	交易
dealer	经销商
Dealer	经销商
dealing	处理
deals	交易
dealt	处理
dear	亲爱的
Dear	亲爱的
death	死亡
Death	死亡
Deb	黛比
Debbie	黛比
debriefing	汇报
decaf	无咖啡因咖啡
Decaf	无咖啡因咖啡
De-caff	无咖啡因的咖啡
decay	衰变
decent	体面的
decide	决定
Decide	决定
decided	决定
decides	决定
deciding	决定
decision	决定
decisions	决定
deck	甲板
decorate	装修
decorated	装饰
decorating	装修
decorations	装饰
dedicated	专用的
Dee	迪
deed	行为
deep	深
deeply	深深
deer	鹿
defeated	打败了
defence	国防
defend	捍卫
defense	国防
defensive	防守
defensively	防守
defiantly	公然
definitely	肯定
Definitely	肯定
defying	不顾
degenerate	简并
degree	学位
dehydrator	脱水器
dejected	情绪低落的
delicate	精致的
delicates	精致的衣服
delicious	美味的
delight	高兴的是
Delighted	很高兴
delightedly	高兴地
delivered	交付
delivers	提供
delivery	交付
Delivery	交付
demand	需求
demolition	拆迁
demonic	恶魔
demonstrate	演示
demonstrates	演示了
Demonstrates	演示了
demonstrating	展示
den	窝
denoted	表示
dense	密集的
dental	牙科
dented	影响
dentist	牙医
deny	否认
departing	离开
Departing	离开
department	部门
Department	部门
departure	离开
depend	依赖
deplane	从飞机上卸下
depressed	抑郁
depressing	令人沮丧的
depression	抑郁症
describe	描述
describes	描述了
deserve	应得的
deserves	值得
Design	设计
desk	桌子上
desks	桌子
Despair	绝望
desperate	绝望的
desperately	拼命
desperation	绝望
destroying	破坏
destruction	破坏
detergent	洗涤剂
Detergent	洗涤剂
determine	确定
determined	确定
devastated	摧毁了
developments	发展
device	设备
devil	魔鬼
Devon	德文郡
devouring	吞噬
dial	刻度盘
dialed	拨
dialing	拨号
dialling	拨号
dialogue	对话
dials	刻度盘
Dials	刻度盘
diaper	尿布
diapers	尿布
diaphram	膜片
dicey	冒险
dicing	切丁
Dick	迪克
did	做了
Did	做了
die	死
Die	死
died	死
Diego	迭戈
dies	死
diet	饮食
Diet	饮食
difference	区别
different	不同的
differently	不同的
difficult	困难
dig	挖
digging	挖掘
dignity	尊严
Digs	挖掘
dim	昏暗的
dimension	维
diner	用餐者
Diner	用餐者
Ding	丁
dings	丁氏
dining	餐厅
dinner	晚餐
Dinner	晚餐
Dino	恐龙
dinosaur	恐龙
dinosaurs	恐龙
dip	浸
diplomat	外交官
diplomatic	外交
dips	下降
direct	直接
direction	方向
directions	方向
directly	直接
director	导演
Director	导演
directs	指导
dirty	脏
disability	残疾
disagreement	分歧
disappears	消失了
disappointed	失望
disappointment	失望
disarray	混乱
disbelief	难以置信
disc	阀瓣
disco	迪斯科
disconnected	断开连接
discover	发现
discovers	发现
Discovery	发现
discreetly	小心翼翼地
discuss	讨论
discussing	讨论
discussion	讨论
disease	疾病
disgust	厌恶
disgusted	恶心
disgustedly	厌烦地
disgusting	恶心的
disgustingly	讨厌地
dish	菜
dishes	热菜
dishevelled	蓬乱的
disk	磁盘
dismissed	驳回了
dismissively	轻蔑地
display	显示
displayed	显示
distance	距离
distract	分散
distracted	心烦意乱
Distractedly	心烦意乱地
distracting	分散注意力的
distracts	分散了
distraught	心烦意乱的
distress	痛苦
Ditto	同上
dive	潜水
diversion	转移
dives	潜水
divide	分
divided	划分
division	部门
Division	部门
divorce	离婚
divorced	离婚了
do	做
Do	做
doctor	医生
Doctor	医生
doctors	医生
documentary	纪录片
Dodge	道奇
does	做
Does	做
t	不
dog	狗
doggedly	顽强地
dogs	狗
doin	什么
doing	做
Doing	做
doll	娃娃
dollar	美元
dollars	美元
dollhouse	玩偶之家
Don	唐
Donald	唐纳德
done	完成
Done	完成
dong	越南盾
Donna	唐娜
donor	捐赠
Donovan	多诺万
dont	其中
don'tI	唐
doobie	吸食大麻
doodle	涂鸦
Doodle	涂鸦
doody	杜迪
Doody	杜迪
doom	厄运
door	门
Door	门
doorbell	门铃
doorknob	门把手
doorpost	门柱
doors	门
doorway	门口
doorways	门口
Dope	涂料
Dora	朵拉
Dorf	多夫
dorks	狗屁不是
Dorothy	多萝西
dot	点
Dot	点
double	双
doubt	怀疑
Doug	道格
dough	面团
Douglas	道格拉斯
Dowdy	懒散的女人
down	下来
Down	下来
downs	波动
Downs	波动
downstairs	在楼下
downward	向下
dozen	打
Dr	博士
Dr.	博士
drag	拖
dragged	拖
dragging	拖
dragon	龙
Dragon	龙
drags	拖
drain	排水
Drake	德雷克
dramatic	戏剧性的
drank	喝了
draped	挂
drapes	窗帘
draw	画
Draw	画
DRAW	画
drawer	抽屉里
drawers	抽屉
drawing	画
drawn	画
draws	吸引了
dreaded	可怕的
dream	梦想
dreamed	梦想
dreaming	做梦
dreams	梦想
dreamy	梦幻
dress	衣服
dressed	穿着
dresser	梳妆台
dresses	礼服
dressing	沙拉酱
dressmaker	裁缝
Drew	画了
drift	漂移
drifted	漂流
drill	钻
drilling	钻井
drink	喝
drinkin	喝下去
drinking	喝
drinks	饮料
dripping	滴
drips	滴
drive	开车
driven	驱动
driver	司机
drivers	司机
drives	驱动器
driving	开车
drooling	流口水
drop	下降
Drop	下降
dropped	下降了
dropping	下降
drops	滴
Drops	滴
drove	开车
drowning	溺水
drum	鼓
drummer	鼓手
drunk	喝醉了
drunken	喝醉酒的
DRUNKEN	喝醉酒的
drunkenly	醉醺醺地
dry	干
dryer	干燥机
dryers	烘干机
drying	干燥
du	由于
dubbed	被称为
dubious	可疑的
Dubious	可疑的
Duchess	公爵夫人
duck	鸭
Duck	鸭
ducking	闪避
ducks	鸭子
duct	管
dude	伙计
Dude	伙计
due	由于
dues	费
dug	挖
duh	咄
Duh	咄
dull	无趣的
dumb	愚蠢的
Dumb	愚蠢的
DUMB	愚蠢的
dumbfounded	目瞪口呆
dumbstruck	吓懵了
dump	转储
dumps	转储
Duncan	邓肯
during	在
dustpan	簸箕
Dutch	荷兰
dwarves	小矮人
dwelling	居住
dying	死亡
Dysprosium	镝
each	每一个
eager	急切的
eagerly	急切地
ear	耳朵
Earl	伯爵
earlier	早些时候
early	早期
earned	赢得了
earphone	耳机
earpieces	头戴式耳机
earring	耳环
earrings	耳环
ears	耳朵
ease	缓解
easier	更容易
easily	很容易
East	东
Easter	复活节
easy	容易
Easy	容易
eat	吃
eaten	吃
eating	吃
eats	吃
eaves	屋檐
eavesdropping	窃听
eavesdrops	偷听
ebola	埃博拉病毒
Ec	电子商务
echo	回声
economics	经济学
Eddie	艾迪
edge	边缘
efficiently	有效地
effort	努力
egg	蛋
eggroll	蛋卷
eggs	鸡蛋
eggshell	蛋壳
eh	嗯
Eh	嗯
eight	八个
Eight	八个
Eighteen	十八
Einstein	爱因斯坦
either	要么
Either	要么
elaborate	精心制作的
elbow	肘
elbows	肘部
electric	电
Electrifying	令人振奋的
electromagnetic	电磁
electronics	电子产品
elegant	优雅的
elephant	大象
elevator	电梯
elf	精灵
Eligible	符合条件的
eliminated	消除
Elizabeth	伊丽莎白
elll	形的
else	其他的
elsewhere	在其他地方
emanating	发出
embarassing	尴尬
embarrassed	不好意思
embarrassing	令人尴尬的
embarrassment	尴尬
emblem	会徽
embrace	拥抱
embryos	胚胎
emerge	出现
emergency	紧急
Emergency	紧急
emerges	出现
emerging	新兴
Emil	埃米尔
Emily	艾米丽
emotion	情感
emotional	情感
emotions	情绪
Emphatic	加强语气的
emphatically	着重
employee	员工
employees	员工
emptier	卸载器
empty	空
Empty	空
encircles	环绕
enclosed	随信附上
encouragingly	令人鼓舞的是
encyclopedias	百科全书
end	结束
END	结束
ended	结束了
endless	没完没了的
ends	结束
energetic	精力充沛的
energy	能源
engaged	订婚了
engagement	订婚
engine	引擎
England	英格兰
English	英语
engorged	塞得满满的
enjoy	享受
Enjoy	享受
enjoyed	享受
enjoying	享受
enormous	巨大的
Enormous	巨大的
enough	足够的
Enough	足够的
ensues	随之而来
enter	输入
Enter	输入
entered	进入
entering	进入
Entering	进入
enters	进入
Enters	进入
entertainment	娱乐
enthused	热情
enthusiasm	热情
enthusiastic	热情的
entire	整个
entirely	完全
entourage	周围的人
entrance	入口
envelope	信封
envelopes	信封
envision	设想
epic	史诗
episode	集
er	呃
Er	呃
erect	勃起的
Eric	埃里克
Erica	艾丽卡
erm	嗯
Ernie	厄尼
erogenous	性感
err	犯错
Err	犯错
errands	差事
error	错误
erupt	爆发
escape	逃避
escapes	逃
escort	护送
escorted	护送
escorts	护送
espresso	浓缩咖啡
est	是
established	建立了
estate	房地产
Estelle	埃斯特尔
Estimated	估计
etc.	等
Ethan	伊森
Euphoria	兴奋
Europe	欧洲
ev	电动汽车
Eve	夏娃
even	甚至
Even	甚至
evening	晚上
event	事件
eventhough	即使
eventually	最终
Eventually	最终
ever	过
Ever	过
Everbody	大家也
Everest	珠穆朗玛峰
everlasting	永恒的
every	每一个
Every	每一个
everybody	每个人都
Everybody	每个人都
everyday	每天
everyone	每一个人
Everyone	每一个人
everything	一切
Everything	一切
everywhere	到处都是
evil	邪恶的
evilly	邪恶地
ew	电子战
Ew	电子战
eww	恶
Eww	恶
ewww	呦
Ewww	呦
exactly	完全
Exactly	完全
exam	考试
Examines	检查
examining	检查
exasperated	愤怒的
ex-boyfriend	前男友
excellent	优秀的
Excellent	优秀的
except	除了
Except	除了
exception	异常
exchange	交换
excited	兴奋
excitement	兴奋
exciting	令人兴奋的
exclamation	感叹
excuse	借口
Excuse	借口
excuses	借口
execute	执行
exert	发挥
ex-girlfriend	前女友
exhale	散发
exhales	呼出
exhibit	展览
ex-husband	前夫
exit	退出
exiting	退出
exits	出口
Exits	出口
exotic	异国情调的
expect	预计
expectant	准
expectation	期望
expecting	期待
expects	预计
expensive	昂贵的
experience	经验
expertly	熟练地
expires	到期
explain	解释
explaining	解释
explanation	解释
exploded	爆炸
exposed	暴露
exposing	暴露
express	表达
Express	表达
expression	表达式
expressions	表达式
expressway	高速公路
extend	扩展
extended	扩展
extends	扩展
extent	程度上
extinct	已经灭绝的
extinguisher	灭火器
extra	额外
extravagant	奢侈的
extremely	极
extricate	解救
exuberance	繁荣
ex-wife	前妻
Exxon	埃克森美孚
eye	眼睛
eyebrow	眉
eyebrows	眉毛
eyed	眼
eyeing	瞄准
eyelashes	睫毛
eyes	的眼睛
Eyes	的眼睛
eyesore	难看的东西
fabulous	令人难以置信的
face	脸
faces	脸
facial	面部
facing	面对
fact	事实
Fact	事实
Factory	工厂
fades	褪色
fails	失败
fair	公平
fairies	仙女
fairyland	仙境
faith	信仰
fake	假的
Fake	假的
fakes	假货
faking	假装
Faking	假装
fall	秋天
fallen	下降
fallin	爱上什么
falling	下降
falls	瀑布
Falls	瀑布
false	假
falters	萎靡不振
Fame	名声
familiar	熟悉
families	家庭
family	家庭
Family	家庭
famished	快要饿死的
famous	著名的
fan	风扇
fancy	花俏的
fans	球迷
fantastic	神奇的
Fantastic	神奇的
fantastically	难以置信地
far	远
Farber	法伯
farm	农场
farmer	农民
fascinated	着迷
fascinating	迷人的
fashion	时尚
fashioned	成形
Fashions	时尚
fast	快
Fast	快
Fasten	系
faster	快
fat	脂肪
Fat	脂肪
father	父亲
Father	父亲
fathers	父亲
fatigues	疲劳
fattest	最胖的
fault	的错
favorite	最喜欢的
favour	支持
favourite	最喜欢的
favours	支持
fawning	奉承的
fax	传真
fear	恐惧
fearfully	非常地
Fears	恐惧
feast	盛宴
feather	羽毛
feathers	羽毛
feature	功能
fed	美联储
feed	饲料
feeding	喂养
feeds	提要
feel	感觉
feeling	感觉
Feeling	感觉
feelings	的感情
feels	感觉
feet	脚
feign	假装
feigns	假装
Felicity	费利西蒂
fell	下降了
fella	小伙子
fellas	伙计们
fellow	研究员
fellows	研究员
felt	感觉
female	女
feminine	女性化的
feminist	女权主义
fence	栅栏
fends	自然
ferry	渡船
fertile	肥沃的
fertility	生育能力
festive	节日
fetch	获取
Fetch	获取
fetches	获取
fetus	胎儿
feverishly	兴奋地
few	几
fewer	更少的
fiance	未婚夫
fiddle	小提琴
field	场
fifteenth	十五
Fifth	第五
fifty	五十
fight	战斗
Fight	战斗
fighting	战斗
Fighting	战斗
figment	虚构的事
figure	数字
figured	算
figures	数据
file	文件
files	文件
filing	申请
Filing	申请
fill	填满
Fill	填满
filled	填满
filling	填充
fills	填满
film	电影
Filming	拍摄
final	最后
finally	最后
Finally	最后
finances	财务状况
find	找到
Finders	发现者
finding	发现
finds	发现
Finds	发现
fine	细
Fine	细
FINE	细
finer	细
finest	最好的
finger	手指
fingernail	指甲
fingernails	指甲
fingers	手指
fini	说完
finish	完成
finished	完成了
finishes	完成
finishing	完成
Finkel	芬克尔
fire	火
Fire	火
fired	解雇了
fireman	消防队员
fires	火灾
firm	公司
first	第一个
First	第一个
fish	鱼
fishes	鱼
fishhook	鱼钩
fishing	钓鱼
fishtank	只鱼缸
fist	拳头
fists	的拳头
fit	适合
fits	适合
five	五个
Five	五个
fiving	五
fix	修复
fixed	固定
fixin	修车
fixing	修复
flag	国旗
flailing	摇摇欲坠的
flails	枷
flame	火焰
flames	火焰
flap	皮瓣
flapping	扑
flash	闪光
flashback	闪回
Flashback	闪回
flashes	闪光
flashing	闪烁的
flask	瓶
flat	平
flattery	奉承
fleas	跳蚤
Flench	割取油脂
flesh	肉
flicked	挥动
flicking	闪烁
flicks	电影
flies	苍蝇
flight	飞行
Flight	飞行
flinch	退缩
flinches	就会闪躲
fling	舞
flingin'flingin	”
flinging	扔
flings	将
Flings	将
Flintstones	的场景
flipping	翻转
flips	翻转
flirtatiously	嗲
flirting	调情
floating	浮动
floor	地板上
Florence	弗洛伦斯
Florida	佛罗里达
floss	牙线
flossing	用牙线清洁牙齿
flounders	深陷泥潭
flower	花
flowers	花
Flowers	花
fluff	绒毛
fluffed	而
Fluffy	毛茸茸的
fluid	流体
flung	扔
flush	冲洗
flushing	冲洗
flustered	慌张
fly	飞
flyer	摩天观景轮
flying	飞行
fo	佛
foam	泡沫
focals	焦
focus	焦点
fold	褶皱
Fold	褶皱
folders	文件夹
folding	折叠
folds	折叠
folks	人
Folks	人
follow	遵循
followed	之后
Followed	之后
following	后
follows	遵循
fondle	抚弄
font	做
food	食物
Food	食物
fool	傻瓜
fooled	愚弄了
foosball	桌上足球
foot	脚
football	足球
footrest	脚凳
footrests	台车
foots	结算
for	为
For	为
forbid	禁止
forced	强迫
Forcefully	有力地
forces	部队
forcing	迫使
Ford	福特
forearm	前臂
fore-arm	前臂
forefinger	食指
forehand	正手
forehead	额头
foreign	外国
Forensics	取证
forever	永远
Forever	永远
forget	忘记
Forget	忘记
forgets	忘记
forgetting	忘记
Forgetting	忘记
forgive	原谅
forgot	忘记
Forgot	忘记了
forgotten	被遗忘的
fork	叉
form	形式
formal	正式的
formation	形成
formerly	以前
forms	形式
Fort	强壮
forth	出来
Fortunata	幸运儿
fortunately	幸运的是
Fortunately	幸运的是
fortune	《财富》杂志
Fortune	《财富》杂志
forty	四十
Forty	四十
forward	向前
fossilised	化石
fossils	化石
Foster	福斯特
found	发现
Found	发现
founder	创始人
four	四个
Four	四个
fourth	第四
Fraiser	干酪
frame	框架
Fran	弗兰
Francis	弗朗西斯
Francisco	旧金山
Frank	弗兰克
Frankie	弗兰基
frantically	疯狂地
franticly	疯狂的
fraud	欺诈
freak	狂
freaked	吓了一
freaking	该死
Freddie	房地美
free	免费的
Free	免费的
freedom	自由
Freedom	自由
frees	释放
freeze	冻结
freezer	冰箱
freezes	冻结
freezing	冻结
French	法国
fresh	新鲜的
freshman	大一新生
Freud	弗洛伊德
Friday	星期五
fridge	冰箱
friend	朋友
friEnd	的朋友
friendly	友好的
friends	朋友
Friends	朋友
friendship	友谊
frightened	害怕
frightenedly	害怕地
frightening	可怕的
frilly	镶褶边的
frisbee	飞盘
from	从
From	从
front	前面
Front	前面
frozen	冻
fruit	水果
Fruit	水果
fruitflies	果蝇
frustrated	沮丧
Frustrated	沮丧
frustration	挫折
frying	煎
fuchsia	樱红色
fuels	燃料
fulfilled	实现了
full	完整的
Full	完整的
fully	完全
fumble	摸索
fumbles	摸索
fun	有趣的
Fun	有趣的
FUN	有趣的
funeral	葬礼
Funeral	葬礼
funniest	最滑稽的
funnily	古怪的
funny	有趣的
Funny	有趣的
fur	皮毛
fur.	皮毛
furious	愤怒的
furnished	有家具的
furniture	家具
further	进一步
future	未来
fuzzy	模糊
Fuzzy	模糊
G.I.	特种部队
gag	呕吐
gagging	矫正
gaining	获得
gal	加
galaxy	星系
game	游戏
Game	游戏
Games	游戏
Gandolf	甘道夫
gang	帮派
garbage	垃圾
Garbage	垃圾
garbled	混乱的
Garden	花园
garment	服装
garrison	驻军
garter	吊袜
gas	气体
gasp	喘息
gasping	喘气
gasps	喘息声
Gasps	喘息声
gate	门
gather	收集
gathered	聚集
gathers	收集
gaudy	俗丽的
gave	给了
GAWD	上帝
gay	同性恋
gaze	的目光
gazes	凝视着
gear	齿轮
Gee	哇
geek	极客
Geena	吉娜
geese	鹅
gel	凝胶
Geller	盖勒
Gellers	盖勒
General	一般
generous	慷慨的
Genie	精灵
genius	天才
gentle	温柔的
gentleman	绅士
gentlemen	先生们
Gentlemen	先生们
gently	轻轻
genuine	真正的
genuinely	真正的
George	乔治
German	德国
gesture	手势
gestures	手势
Gestures	手势
gesturing	手势
Gesturing	手势
get	得到
Get	得到
GET	得到
gets	得到
Gets	得到
gettin	捞到
Gettin	捞到
getting	得到
Getting	得到
giant	巨大的
Giants	巨人
gibberish	胡言乱语
giddy	头晕
gift	礼物
Gift	礼物
gifts	礼物
gig	演出
giggle	咯咯地笑
giggles	咯咯地笑
Giggles	咯咯地笑
giggling	咯咯地笑
Gin	杜松子酒
ginger	姜
Ginger	姜
giorno	义大利
girl	女孩
GIRL	女孩
girlfriend	的女朋友
Girlfriend	的女朋友
girlie	少女
girls	女孩
give	给
Give	给
GIVE	给
given	鉴于
gives	给了
Gives	给了
giving	给
glad	很高兴
Glad	很高兴
glances	目光
Glances	目光
glare	眩光
glares	的目光
Glares	的目光
glaring	明显的
glass	玻璃
glasses	眼镜
glaze	釉
glitter	闪闪发光的
globe	全球
glory	荣耀
glove	手套
gloves	手套
glower	热切的注视
glue	胶水
glued	粘
G'nightG	夜间
go	去
Go	去
goal	目标
goalie	守门员
Goat	山羊
goatee	山羊胡子
goats	山羊
god	神
God	神
GOD	上帝
goes	去
Goes	去
goggles	护目镜
goin	戈因
Goin	戈因
going	会
goings	行为
gold	黄金
golden	金
goldfish	金鱼
Goldman	高盛
golf	高尔夫球
golfing	打高尔夫球
gon	百分度
gone	走了
Gone	走了
goo	咕
good	好
Good	好
goodbye	再见
Goodbye	再见
goodness	善
goodnight	晚安
Goodnight	晚安
gooey	感伤的
goofy	高飞
GOOOD	很好的
goop	黏糊糊的东西
gorgeous	华丽的
gosh	天啊
Gosh	天啊
got	得到了
Got	得到了
Gotcha	问题
gotten	得到
governor	州长
gown	礼服
grab	抓住
Grab	抓住
grabbed	抓住了
grabbing	抓住
Grabbing	抓住
grabs	抓住
Grabs	抓住
grace	恩典
grade	年级
graduated	毕业
graduation	毕业
Graduation	毕业
grand	伟大的
GRANDCHILDREN	孙子
granddaughter	的孙女
grandfather	祖父
Grandfather	祖父
grandma	奶奶
Grandma	奶奶
grandmother	祖母
Grandmother	祖母
Grandpa	爷爷
grandparents	爷爷奶奶
grapes	葡萄
grasp	掌握
grasps	掌握
grave	坟墓
gravity	重力
gravy	肉汁
gray	灰色的
grease	油脂
great	伟大的
Great	伟大的
greatest	最大的
Greek	希腊
green	绿色
Green	绿色
Greene	格林
Greenstein	格林斯坦
greeter	迎宾
greeting	问候
Grey	灰色
greyhound	灰狗
grief	悲伤
grill	烧烤
grilled	烤
grilling	烧烤
grim	严峻的
grimace	鬼脸
grimaces	鬼脸
grimacing	扮鬼脸
Grimacing	扮鬼脸
grin	露齿而笑
grinder	磨床
grinding	磨
grinds	磨
grinning	咧着嘴笑
grins	笑容
gritted	紧咬着
groan	呻吟
groaning	呻吟
groans	呻吟
groceries	食品杂货
grocery	杂货店
groomsmen	伴郎
gross	总值
Gross	总值
grossed	票房
grotesquely	奇异地
ground	地面
group	集团
grow	成长
growing	日益增长的
growl	咆哮
growling	咆哮
growls	咆哮
grrreat	真是棒极了
grunts	普通员工
Grunts	普通员工
guard	警卫
guess	猜一猜
Guess	猜一猜
guessed	猜到了
guest	客人
guests	客人
Guggenheim	古根海姆
guidance	指导
guide	指南
guides	指南
guilt	内疚
guilty	有罪
guitar	吉他
gulp	狼吞虎咽地吃
gum	口香糖
Gum	口香糖
Gummi	树胶
gun	枪
gunfighter	枪手
gunpoint	枪口
gunshot	枪击
Gunther	冈瑟
gurney	格尼
guru	大师
Guru	大师
gut	肠道
guts	勇气
guy	的家伙
Guy	的家伙
guys	人
Guys	人
gym	健身房
Gym	健身房
gym.	健身房
GYN	妇科
gynaecologist	妇科医生
hacking	黑客
had	有
hah	哈
Hah	哈
haha	哈哈
hair	头发
haircut	发型
hairline	发际线
hairy	多毛的
half	一半
halfway	一半
hall	大厅
Hall	大厅
hallway	走廊
Hallway	走廊
halt	停止
hamburgers	汉堡包
Hammel	哈梅尔
hammer	锤
hammock	吊床
hamper	阻碍
hand	手
Hand	手
handcuffed	戴上手铐
handcuffs	手铐
handed	递给
handful	一些
handheld	手持
handing	将
handkerchief	手帕
Handkerchief	手帕
handle	处理
handles	处理
hands	手
Hands	手
handsome	英俊的
hang	挂
Hang	挂
hanger	悬挂器
hangers	衣架
hanging	挂
hangs	挂起
Hangs	挂起
Hans	汉斯
happen	发生
happened	发生了
happening	发生
Happening	发生
happens	发生
happily	幸福的
Happily	幸福的
happy	快乐
Happy	快乐
hard	硬
Hard	硬
hardball	硬式棒球
hardens	变硬
harder	困难
hardest	最严重的
hardly	几乎没有
Hardly	几乎没有
Harry	哈利
has	有
Has	有
Hasselhoff	哈塞尔霍夫
hasty	匆忙的
hat	帽子
hate	讨厌
Hate	讨厌
hated	讨厌
hates	讨厌
hating	讨厌
hats	帽子
hauling	搬运
have	有
Have	有
having	有
hazel	黑兹尔
he	他
He	他
head	头
Head	头
headfirst	头
heading	标题
headphones	耳机
heads	头
Heads	头
headway	进展
Healing	疗愈
health	健康
healthy	健康的
hear	听到
heard	听到
Heard	听到
hearing	听力
Hearing	听力
hears	听到
heart	心
heartbeat	心跳
hearts	心
heat	热
Heat	热
heaven	天堂
heavily	严重
heavy	重
Heckles	的抨击
heel	跟
Heeling	倾斜
Heh	哈
Heimlich	海姆利希
hel	冥界
Hel	冥界
held	举行
Helen	海伦
Helens	海伦斯火山
helicopter	直升机
hell	地狱
Hell	地狱
hello	你好
Hello	你好
Helmut	赫尔穆特
help	帮助
Help	帮助
helped	帮助
helper	助手
helpers	助手
helping	帮助
helplessly	无助地
helps	帮助
Henderson	亨德森
her	她的
Her	她的
herbal	草药
Herbal	草药
herbalist	草药医生
here	在这里
Here	在这里
hero	英雄
hers	她的
herself	自己
Hersey	赫西
hes	他
hesitates	犹豫了一下
Heston	赫斯顿
hey	嘿
Hey	嘿
HEY	嘿
hi	嗨
Hi	嗨
hide	隐藏
Hide	隐藏
hideous	可怕的
Hideously	出奇的
hides	隐藏了
hiding	隐藏
high	高
High	高
higher	更高的
highly	高度
highway	高速公路
hike	徒步旅行
Hike	徒步旅行
hikes	上涨
hilarious	非常滑稽的
him	他
himself	自己
hint	提示
hip	臀部
hips	臀部
hire	雇佣
hired	聘请了
hiring	招聘
his	他的
His	他的
hiss	嘶嘶声
hissing	发出嘶嘶声
history	历史
History	历史
hit	打击
hits	支安打
Hits	支安打
hitting	打
Hm	嗯
Hm.	嗯
hmm	嗯
Hmm	嗯
hmm.	嗯
Hmm.	嗯
ho	何
hobble	瘸一拐的
hockey	曲棍球
Hockey	曲棍球
hold	持有
Hold	持有
holder	持有人
holders	持有人
holding	持有
Holding	持有
holds	持有
Holds	持有
hole	洞
holes	孔
holiday	假期
Holiday	假期
holidays	假期
Holland	荷兰
holy	神圣的
home	家
Home	家
homerun	全垒打
homesick	想家
homosexually	性渠道
hon.	亲爱的
honey	蜂蜜
Honey	蜂蜜
honeymoon	度蜜月
honk	按汽车喇叭
honks	按响喇叭
Honor	荣誉
honorary	荣誉
honour	荣誉
honoured	荣幸
hoo	呼!
hood	罩
hoods	抽油烟机
hook	钩
hooked	钩状的
hooker	妓女
hooking	连接
hoop	呼啦圈
hop	跳
hope	希望
Hope	希望
hoped	希望
hopefully	希望
hopeless	绝望的
hopes	希望
hoping	希望
hopping	跳来跳去
hops	啤酒花
horn	角
horny	角质
horrible	可怕的
horribly	可怕的
horrified	吓坏了
horror	恐怖
hose	软管
Hoshi	法师
hospital	医院
Hospital	医院
hostess	女主人
hot	热
hotel	酒店
hotline	热线
hottest	最热的
hour	小时
hours	小时
house	房子
House	房子
household	家庭
housekeeper	管家
houses	房子
housewares	家用器皿
how	如何
How	如何
Howard	霍华德
Howdy	你好
however	然而
However	然而
howls	嚎叫
huddle	挤作一团
hug	拥抱
Hug	拥抱
huge	巨大的
hugging	拥抱
Hugging	拥抱
Hugo	雨果
hugs	拥抱
Hugs	拥抱
huh	哈
Huh	哈
hula	草裙舞
Hulk	绿巨人
hum	嗡嗡声
humidity	湿度
Humm	嗯
humming	嗡嗡作响
hummus	鹰嘴豆泥
humor	幽默
humour	幽默
humouring	迁就
humping	呈驼峰状
hums	嗡嗡
hunched	弯腰驼背
hundred	几百
hundreds	数百
hundredth	第一百位
hung	挂
hungover	心里难受的
hungry	饿了
hunk	大块
hurl	投
hurriedly	赶紧
Hurriedly	赶紧
hurries	鼓起勇气
hurry	快点
Hurry	快点
hurrying	匆匆
hurt	伤害
hurts	伤害了
husband	丈夫
Hushes	嘘
hymn	赞美诗
hypnosis	催眠
hysterically	歇斯底里地
i	我
I	我
I.	我
ice	冰
Ice	冰
iced	冰
icky	令人作呕的人
icy	冰冷的
idea	的想法
ideal	理想的
ideally	在理想的情况下
ideas	的想法
identical	相同的
idiot	白痴
Idiot	白痴
if	如果
If	如果
ignorance	无知
ignore	忽略
ignores	忽略了
ignoring	忽略
ill	生病了
Im	即时通讯
image	图像
imaginary	虚构的
imagination	想象力
imagine	想象一下
Imagine	想象一下
imagining	想象
imitate	模仿
imitates	模仿
Imitates	模仿
imitating	模仿
Imitating	模仿
immediately	立即
immediatly	马上
immigration	移民
imp	小鬼
impatient	没耐心的
impatiently	不耐烦地
impish	顽皮的
important	重要的
impressed	深刻的印象
impression	印象
impressions	印象
improper	不当
improved	改进的
improvises	自拍
in	在
In	在
in.	在
In.	在
in-a-can	在一个罐子里
inadequate	不充分的
inanely	愚蠢地
inappropriate	不合适的
Inc.	公司
inches	英寸
incident	事件
incidentally	偶然
including	包含
incoherent	颠三倒四
incoherently	语无伦次
inconvenience	不方便
incredible	难以置信
Incredible	难以置信
incredibly	令人难以置信
index	指数
Indian	印度人
Indiana	印地安那
Indians	印度人
indicate	表明
indicates	指示
indicating	说明
Indicating	指示
indifference	漠不关心
indistinctly	朦胧地
indoors	在室内
inedible	不可食用
inflated	充气
inflection	拐点
info	信息
information	信息
inhaling	吸入
inimitable	独特的
in-in	在入
initials	声母
injure	损伤
ink	墨
inner	内
in-No	在否
innocent	无辜
innocently	傻傻
Innsbruck	因斯布鲁克
inquiry	查询
insane	疯
insanely	疯狂地
inseam	裆
insect	昆虫
insensitive	麻木不仁
inside	内
Inside	内
insider	内幕
Insincerely	言不由衷
insist	咬定
insistently	执意
insisting	坚持
inspecting	检查
Inspiration	灵感
inspired	启发
installing	安装
instant	瞬间
instead	代替
Instead	代替
instrament	仪器
instruction	指令
instructions	说明
instrument	仪器
insulted	受辱
insults	侮辱
insurance	保险
Insurance	保险
intelligence	情报
intense	激烈
intensely	激烈
intentionally	故意地
intently	一心一意
intercepted	截获
intercepts	拦截
intercom	对讲
Intercom	对讲
interest	利益
interested	有兴趣
interesting	有趣
Interesting	有趣
interfering	干扰
interior	内部
Interiors	室内设计
international	国际
International	国际
internet	互联网
interrupt	打断
interrupted	间断
interrupting	中断
Interrupting	中断
interrupts	中断
interview	访问
interviewer	面试官
interviewing	面试
interviews	面试
intimacy	亲密关系
intimate	亲密
into	成
Into	成
intrigued	好奇
introduce	介绍
introduces	介绍
Introduces	推出
introducing	引入
Introducing	介绍
introduction	介绍
investigating	调查
invisible	无形
Invisible	无形
invitation	请帖
invitations	邀请函
invite	邀请
invited	邀请
inviting	诱人的
invoice	发票
involved	参与
Iris	鸢尾花
Irish	爱尔兰的
irked	激怒
Ironically	讽刺地
irony	讽刺
irreplaceable	不可替代
is	是
Is	是
Isaac	艾萨克
Isabella	伊莎贝拉
island	岛
isle	小岛
isolation	隔离
Israel	以色列
issue	问题
issues	问题
it	它
It	它
Italian	意大利
italics	斜体
Italy	意大利
itches	痒
itchy	发痒的
item	项目
items	项目
Ithica	伊萨卡
itinerary	行程
its	它的
Its	它的
jab	戳
jabbering	叽叽喳喳
jabs	刺戳
jack	插口
Jack	插口
jacket	夹克
jackets	夹克
jackhammer	手持式凿岩机
jacks	千斤顶
Jade	玉
Jag	乱切
Jaguar	捷豹
jail	监狱
jam	果酱
Jam	果酱
James	詹姆士
Jamie	杰米
jamming	拥塞
jams	果酱
Jan	一月
Janice	贾尼斯
Too	珍妮丝
janitor	门警
Japan	日本
jar	罐
jars	罐子
Jasmine	茉莉花
Jason	贾森
JavaJava	的
jazz	爵士乐
jealous	妒
Jean	吉恩
Jeannie	珍妮
Jeannine	珍妮
jeans	牛仔裤
Jeepers	车友
jeez	哎呀
Jeez	哎呀
Jello	果冻
jellyfish	海蜇
Jellyfish	海蜇
Jeni	杰尼
Jennifer	詹妮弗
jerk	混蛋
Jerry	杰瑞
Jetson	特森
jetway	捷波
Jetway	捷波
Jew	犹
jewelery	首饰
jeweller	珠宝商
jewelry	首饰
jig	夹具
Jill	吉尔
Jim	吉姆
jingle	叮铃
Jingle	叮铃
jingles	顺口溜
Jll	仲量联行
Jo	乔
Joan	琼
Joanna	乔安娜
Joanne	乔安妮
job	工作
jobs	工作
jock	乔克
Joe	乔
Joel	乔尔
Joey	乔伊
jog	慢跑
jogging	跑步
jogs	慢跑
John	约翰
Johnson	约翰逊
join	加入
joined	加盟
joining	加盟
joins	加入
Joins	加盟
joint	联合
jointed	节理
joke	玩笑
jokes	笑话
Jones	琼斯
Jonny	强尼
Jordan	约旦
Joseph	约瑟夫
Josh	玩笑
Joshua	约书亚
journal	日志
Jovi	·乔维
joy	喜悦
joyous	欢乐
ju	菊
Ju	菊
Judge	法官
Judging	评审
judgment	判断
judgmental	评判
Judy	朱迪
juice	果汁
jukebox	点唱机
Jules	儒勒
Julie	朱丽叶
Julio	胡里奥
July	七月
jump	跳
jumped	跳下
jumping	跳跃
Jumping	跳跃
jumps	跳跃
June	六月
jungle	丛林
junior	初级
Junior	初级
junk	破烂
Jurassic	侏罗纪
jus	强制
just	只是
Just	只是
K	ķ
Kane	凯恩
Kaplan	卡普兰
Karen	卡伦
Karl	卡尔
Kate	凯特
Kathy	凯西
kay	凯
Kay	凯
keep	保持
Keep	保持
keepers	饲养员
keeping	保持
keeps	保持
Kennedy	肯尼迪
kept	不停
kerb	抑制
kettle	水壶
Kevin	凯文
key	键
keyboard	键盘
keyboards	键盘
keyed	键控
keys	按键
kibbles	粗粉
kick	踢
kicked	踢
kickin	起作用
kicking	踢
kicks	踢
Kicks	踢
kid	孩子
kidding	开玩笑
Kidding	开玩笑
kidney	肾
kids	孩子
Kids	童装
Kiki	琪琪
kill	杀
killed	杀害
killers	杀手
killing	谋杀
kind	类
kinda	有点儿
kindergarten	幼儿园
kinds	种
king	王
King	王
kingdom	王国
Kingdom	王国
Kip	基普
kiss	吻
Kiss	吻
kissed	吻
Kissed	吻
Kisser	接吻
kisses	吻
Kisses	吻
kissing	接吻
kit	套件
kitchen	厨房
Kitchen	厨房
kite	风筝
kitten	小猫
kittens	小猫
kitty	猫咪
Kitty	猫咪
Kleenex	薄纸
Klein	克莱恩
knapsack	背包
knee	膝盖
kneed	用膝盖顶
kneeling	跪
kneels	跪
knees	膝盖
knew	知道
Knicks	尼克斯
knife	刀
knight	骑士
Knight	骑士
Knights	骑士
knit	针织
knitting	针织
knob	把手
knock	敲
Knock	敲
knocked	被撞
knocking	敲门
knockout	昏死
knocks	敲门
Knocks	敲门
know	知道
Know	知道
knowing	会心
knowledge	知识
known	已知
knows	知道
Korean	朝鲜的
Kostelic	科斯泰莉茨
Kristen	克里斯汀
Kristin	克里斯汀
Kung	功夫
L.A.	湖人
la	啦
La	啦
lab	实验室
labelling	标签
labels	标签
labour	劳工
lace	花边
ladder	阶梯
ladies	女士们
Ladies	女士们
lads	小伙子
lady	淑女
ladybug	瓢虫
lagging	滞后
laid	铺设
lake	湖
Lambert	兰伯特
lamp	灯
land	土地
landed	登陆
landlord	房东
landmarks	地标
lands	土地
landscaping	美化
language	语言
languages	语言
lap	膝部
lap.	一圈
laps	圈
lapse	失误
Lapse	失误
laptop	笔记本电脑
Lara	拉拉
large	大
Las	拉斯维加斯
lasagna	烤宽面条
lasagnas	烤宽面条
lasagne	千层面
laser	激光
last	持续
Last	持续
lasted	历时
late	晚了
Late	晚了
lately	最近
later	后来
Later	后来
lather	泡沫
Lather	泡沫
Latin	拉丁
lations	办法第十四
latte	拿铁
laugh	笑
laughable	可笑
laughing	笑
Laughing	笑
laughs	笑
Laughs	笑
laughter	笑声
lauging	笑
laundromat	自助洗衣房
Laundromat	自助洗衣房
laundry	洗衣店
Laundry	洗衣店
Lauren	劳伦
Laurie	劳瑞
law	法
lawfully	合法地
lawn	草坪
Lawrence	劳伦斯
lax	松
lay	铺设
layer	层
laying	铺设
lays	乐事
Lays	乐事
le	乐
lead	铅
leading	领导
leads	引线
leaf	叶
league	联盟
lean	靠
Lean	靠
leaning	倚
leans	斜靠
leap	飞跃
leaping	跳跃
leaps	飞跃
leaqve	离开
learn	学习
Learn	学习
learned	学到了
learning	学习
leashes	牵引绳
least	最小
leather	皮革
leave	离开
leaves	树叶
Leaves	树叶
leaving	离开
Lebanon	黎巴嫩
lecture	演讲
lectured	演讲
lecturing	演讲
ledge	窗台
Lee	背风处
left	剩下
leftover	剩
leftovers	残羹剩饭
leg	腿
legs	腿
Leia	累啊
Lem	莱姆
Lemon	柠檬
lemonade	柠檬汽水
length	长度
Lenny	莱尼
Leonard	伦纳德
Leroy	乐华
lesbian	女同性恋
Lesbian	女同性恋
Leslie	莱斯利
less	减
Less	减
lesson	课
Lesson	课
let	让
Let	让
Let's	让我们
letter	信件
letters	信
letting	出租
lever	杠杆
li	里
Liam	利亚姆
Liberace	利贝拉切
Liberty	自由
library	图书馆
Library	图书馆
license	执照
lick	舔
Licker	刺辊
lickers	刺辊
licks	舔
lid	盖
lie	位于
lies	谎
life	生活
lifetime	一生
lift	电梯
lifting	吊装
lifts	升降机
light	光
lighter	打火机
lighting	灯光
lightly	轻轻
lightning	闪电
Lightning	闪电
lights	灯火
Lights	灯火
like	喜欢
Like	喜欢
liked	喜欢
likely	容易
Likeness	像
likes	喜欢
Likewise	同样
lilly	礼来公司
lilt	轻快
lily	百合
Lily	百合
limbs	四肢
limo	豪华轿车
limp	跛行
limps	颠
Lincoln	林肯
line	线
lined	夹
linen	麻布
liner	衬垫
lines	线
lingerie	女用贴身内衣裤
lint	皮棉
lion	狮子
Lion	狮子
Lionel	莱昂内尔
lip	唇
lips	嘴唇
lipstick	口红
liquor	酒
liquorice	甘草
Lisa	丽莎
list	名单
List	名单
listen	听
Listen	听
listening	听
listens	监听
Listens	监听
lists	名单
lit	发光的
literally	按照字面
Literature	文献
litter	窝
little	小
Little	小
live	生活
lived	生活
liver	肝
livered	胆小的
lives	生活
Lives	生活
livin	活着
living	活的
Living	活的
Livingston	利文斯顿
lizards	蜥蜴
'll'	二
lo	罗
Lo	罗
load	加载
loaded	装
loads	负载
loaf	面包
loathe	厌恶
lobby	前厅
lobster	龙虾
lobsters	龙虾
local	本地
lock	锁
locked	锁定
locker	更衣室
locking	锁定
locks	锁
logo	商标
loincloth	缠
Lola	萝拉
London	伦敦
lonely	孤独
long	长
Long	长
longer	长
longingly	渴望
look	看
Look	看
looked	看着
lookin	顺便拜访
looking	看着
Looking	看着
looks	容貌
Looks	容貌
loong	龙
loop	环
loosely	松弛地
looters	乱兵
Lord	主
Lori	洛瑞
Lorraine	洛林
lose	失去
loser	失败者
Loser	失败者
losers	失败者
loses	失去
losin	会输
losing	失去
Losing	失去
loss	失利
lost	丢失
lot	批量
lots	地段
loud	响
louder	响
Louder	再大一点
loudly	高声
Loudly	高声
love	爱
Love	爱
loveable	可爱
loved	喜爱
lovely	可爱
lover	情人
loves	爱
lovingly	含情脉脉
low	低
lower	降低
lowering	降低
lowers	降低
Lucille	露西尔
luck	运气
luckiest	幸运
Luckily	幸
lucky	幸运
Lucky	幸运
Ludwins	路金一家人
luggage	行李
lugging	拖着
Luisa	路易莎
lumber	木料
luminous	发光的
lumps	硬块
lunch	午餐
lunchbox	午餐盒
lung	肺
lunges	弓步
lunging	冲刺
lungs	肺
lure	饵
lures	诱惑
lust	情欲
Lydia	莉迪亚
lyin	说谎
lying	说谎
lyme	莱姆
Lynch	林奇
lyrics	歌词
M	中号
m.	米
M.E.	我
ma	嘛
Ma	嘛
Macaroons	杏仁饼
mache	纸型
machine	机
Machine	机
machines	机
Maclean	麦克林
Macy	梅西
mad	狂
made	制作
Made	制作
Madison	麦迪逊
madman	狂人
MADNESS	疯狂
magazine	杂志
magazines	杂志
magic	魔法
magical	神奇
Magician	魔术师
Magna	麦格纳
maid	女佣
Maid	女佣
mail	邮件
mailbox	邮箱
mailing	邮件
mailman	邮递员
mails	邮件
main	主要
mainly	主要
major	重大的
make	使
Make	使
maker	制作者
makes	品牌
Makes	使
makeup	化妆
makin	马金
making	制造
Making	制造
Malcom	马尔科姆
male	男
mama	妈妈
man	人
Man	人
manages	管理
maneuver	演习
Manhattan	曼哈顿
maniac	疯子
maniacal	疯狂的
manicure	修指甲
manipulates	操纵
manipulative	操控
mannaquin	模特
manner	方式
mannered	彬彬有礼
manual	手册
many	许多
map	地图
marathon	马拉松
Marc	渣
Marceau	·玛索
Marcel	马塞尔
march	游行
margaritas	玛格丽塔
Marge	玛吉
Marie	玛丽
marinara	林纳拉
Mario	马里奥
Marjorie	马乔
mark	标记
Mark	标记
marked	标
markers	标记
marking	印记
marks	分数
Marks	分数
marriage	婚姻
married	已婚
Marriott	万豪酒店
marry	结婚
Marry	结婚
marrying	结婚
Marsha	玛莎
Marshal	元帅
Martha	玛莎
martini	马蒂尼鸡尾酒
Mary	玛丽
mascara	睫毛膏
mascot	吉祥物
masher	捣碎
massage	按摩
Massage	按摩
massages	按摩
massaging	按摩
massive	大规模的
Master	主
mastered	掌握
mat	垫
matador	斗牛士
match	比赛
Matches	火柴
mate	伴侣
maternity	母道
mates	队友
math	数学
matter	物
matters	事项
Matthews	马修斯
mattress	床垫
Mattress	床垫
Max	马克斯
may	可以
May	可以
maybe	也许
Maybe	也许
McDowell	麦克道尔
me	我
Me	我
ME	我
meadow	草地
meal	膳食
meals	餐
mean	意思
meaning	含义
means	手段
meant	意味着
meantime	与此同时
Meanwhile	与此同时
measure	测量
measured	测量
measures	措施
meat	肉
mechanic	机械
mechanism	机制
medals	奖牌
mediating	中介
medical	医
Medical	医
medieval	中世纪
Medley	混合
Mee	眉
meet	遇到
Meet	遇见
meeting	会议
meets	符合
melancholy	愁绪
Melanie	梅兰妮
Melba	梅尔巴
mellow	醇厚
melodramatically	情节性
melon	瓜
melt	熔化
melting	融化
member	会员
members	会员
membership	籍
memories	回忆
memorise	记忆
memorize	记忆
memorizing	记忆
memory	记忆
memos	备忘录
men	男人
Men	男人
mendelevium	钔
Mendels	门德尔斯
menstruating	月经
mention	提到
mentioned	提到
mentioning	提
menu	菜单
mermaid	美人鱼
merry	快活
Merry	快活
mesh	啮合
mess	食堂
message	信息
messages	消息
Messier	梅西耶
messing	搞乱
met	会见
Mexico	墨西哥
Mi	弥
Michael	迈克尔
Michelle	米歇尔
microphone	麦克风
microscope	显微镜
microscopes	显微镜
Microwave	微波
middle	中间
midget	侏儒
midgets	侏儒
midnight	午夜
Midnight	午夜
midtown	市中心
miffed	恼火
might	威力
Might	威力
mighta	可能走
mighty	威武
migrate	迁移
mike	麦克风
Mike	麦克风
Milan	米兰
miles	英里
military	军事
milk	牛奶
Milk	牛奶
milkshake	奶昔
Miller	磨坊主
million	百万
mimes	默剧
mimic	模仿者
mimicking	模仿
Mimicking	模仿
mimicks	模拟了
miming	假唱
Min	敏
mind	心神
Mind	心神
Mindy	柯以敏
mine	矿
Mine	矿
mingling	采风
mini	微型
miniature	微型
Minister	部长
mini-wave	迷你波
Minsk	明斯克
mint	薄荷
Mint	薄荷
mints	薄荷糖
minus	减去
minute	分钟
minutes	分钟
Mira	米拉
miracle	奇迹
Miracle	奇迹
mirror	镜子
mirroring	镜像
Mischa	米莎
miserably	非常不幸地
Miserably	非常不幸地
misery	苦难
misfires	失火
miss	小姐
Miss	小姐
miss.	小姐
missed	错过
misses	错过
missing	失踪
mission	任务
Mississippi	密西西比州
Missouri	密苏里州
mistake	错误
mister	先生
Mister	先生
mistletoe	槲寄生
misunderstanding	误解
Mitchell	米切尔
mittens	手套
Mitzi	米齐
mix	混合
Mix	混合
mixed	杂
mm	毫米
Mm-hmmmMM-	嗯
Mmm	嗯
mmm.	嗯
Mmm.	嗯
Mmmm	嗯
Mmmm.	嗯
moaning	呻吟
moans	呻吟
mocking	嘲讽
Mocking	惩戒
mockolate	缀有蘑古力
Mockolate	缀有蘑古力
Mod	国防部
mode	模式
model	模型
models	楷模
Modern	现代
moistening	润燥
moisturiser	保湿
mole	痣
mom	妈妈
Mom	妈妈
moment	时刻
momentarily	瞬间
moments	瞬间
Momma	妈妈
mommy	妈妈
Mommy	妈妈
Mon	周一
Mon.	周一
Moncia	莫妮卡
Monday	星期一
money	钱
Monica	莫妮卡
Mon-i-ca	周一我
monkey	猴
Monkey	猴
monkeyish	调皮
Monopoly	垄断
monster	怪物
montague	蒙塔古
Montauk	蒙托克
Montgomery	蒙哥马利
month	月
months	个月
Montreal	蒙特利尔
Monty	蒙蒂
moo	哞
mood	心情
mooing	鸣叫
Moondance	月舞
moonlight	月光
moose	驼鹿
mopeds	轻便摩托车
mopping	扫荡
moral	道德
more	更多
More	更多
mornin	清晨
Mornin	清晨
morning	早上
Morning	早上
mortified	羞愧
Mortified	羞愧
most	最
Most	最
mostly	大多
Mostly	大多
mother	母亲
Mother	母亲
mothers	母亲
motif	主题
motion	运动
motions	运动
Motions	议案
motor	发动机
motorcycle	摩托车
mountain	山
mouse	老鼠
mousse	摩丝
mousses	摩丝
moustache	胡子
mouth	口
mouthed	口
mouthful	一口
mouthing	唱衰
mouths	嘴巴
move	移动
Move	移动
moved	移动
mover	动
movers	搬运工
moves	移动
Moves	移动
movie	电影
movies	电影
movin	居无定所
moving	移动
Moving	移动
Mr	先生
Mr.	先生
Mrs	太太
Mrs.	太太
Ms	女士
Ms.	女士
Mt.	公吨
much	许多
mud	泥
muddy	浑
muffin	松饼
muffled	闷响
mug	杯
mugs	马克杯
mulling	酝酿
multinational	跨国
multipage	多页
multiple	多
mumbles	曼波斯
muppet	布偶
Muppet	布偶
murder	谋杀
muscle	肌肉
muscles	肌肉
museum	博物馆
Museum	博物馆
museums	博物馆
mushroom	蘑菇
mushrooms	蘑菇
music	音乐
Music	音乐
musical	音乐
musicians	音乐家
Mussolini	墨索里尼
must	必须
Must	必须
mustard	芥末
mustering	卯足
mutes	静音
mutters	嘟囔
my	我的
My	我的
myself	我
Myself	我
n	ñ
na	呐
Naa	萘乙酸
Nada	纳达
Nah	罗
nail	钉
nails	钉子
Nails	钉子
naked	裸
Naked	裸
name	名称
named	命名
names	名
nametag	名称标签
naming	命名
Nana	娜娜
nap	小憩
napkin	餐巾
nasal	鼻音
nasally	鼻
national	国民
natural	自然
Natural	自然
nature	性质
naughty	淘气
nausea	恶心
nauseous	恶心
navigated	导航
Navy	海军
ndashndash	的
near	近
nearby	附近
neat	整齐
neatness	整洁
necessary	必要
neck	颈部
necklace	项链
Ned	斯内德
need	需要
needed	需要
needing	需要
needle	针
Needless	不必要
needs	需求
needy	贫穷
negative	负
negativity	消极
negligent	懈
negotiating	谈判
negotiation	谈判
neice	内测
neighbor	邻居
Neighborhood	邻里
neighbour	邻居
neighbours	邻居
Neil	尼尔
Neither	也不
nephew	外甥
nervous	紧张
Nervous	紧张
nervously	紧张
Nervously	神经质
Net	净
Netherlands	荷兰
neurosurgeon	神经外科医生
never	决不
Never	决不
nevermind	没关系
new	新
New	新
newborn	新生
Newman	新人
news	新闻
newsletter	通讯
newspaper	报纸
newspapers	报纸
next	下一个
Next	下一个
Ni	你
nibbling	嗑
nice	不错
Nice	尼斯
nicer	更好
Nick	缺口
nickel	镍
nickname	昵称
nicotine	尼古丁
niece	侄女
night	晚
Night	晚
nightclub	夜店
nightie	睡衣
nighties	睡衣
nightmare	恶梦
Nike	耐克
Nina	尼娜
nine	九
ninety	九十
Nip	掐
nipple	乳头
nipples	乳头
no	没有
No	没有
NO	没有
No.	没有
Nobel	诺贝尔
nobody	没有人
Nobody	没有人
nocturnal	夜
nod	点头
nodded	点头
nodding	点头
nods	点头
noise	噪声
noises	噪音
noisily	吵闹
noisy	吵
nonchalantly	漠不关心地
none	没有
None	没有
non-fat	非脂
Nono	不
Noo	野应
noodle	面条
noodles	面条
Nooo	拿去
No-o-o	没有
Nooooo	真是没有
nope	不
Nope	不
Nora	诺拉
normal	正常
north	北
North	北
nose	鼻子
noses	鼻子
nostril	鼻孔
not	不
Not	不
note	注意
Note	注意
notebook	笔记本
notepad	记事本
nothin	没什么
nothing	没有
Nothing	没有
notice	注意
noticed	注意到
notices	通告
Notices	通告
noticing	注意到
nouse	公司内
now	现在
Now	现在
nowhere	无处
n't	不
nubbin	片体
Nuh	新加坡国立大学医院
number	数
Number	数
numbers	数字
nuptials	婚礼
nurse	护士
nurses	护士
nut	坚果
nuts	坚果
nutty	疯狂的
oak	橡木
oatmeal	麦片
obeys	服从
obituaries	讣告
obligation	义务
obnoxiously	令人讨厌
observes	观察
Obsession	困扰
obsessive	强迫症
obvious	明显
obviously	明显
occasion	场合
occasionally	偶尔
occupied	占据
occuring	发生的历史
o'clock	点
odour	气味
of	的
Of	的
OF	的
off	离
Off	离
OFF	关闭
offence	罪行
offense	罪行
offer	提供
offering	供
Offering	供
offers	报价
office	办公室
Office	办公室
officially	正式
Og	噩
oh	哦
Oh	哦
OH	哦
ohh	喔
Ohh	喔
ohhh	哦~~
Ohhh	哦~~
Ohhhh	天上
oil	油
oils	油
Oink	哼
ok	好
Ok	好
OK	好
okay	好的
Okay	好的
O-kay	好的
Oke	奥凯
old	旧
Old	旧
older	旧的
Ole	奥勒
olive	橄榄
Oliver	奥利弗
olives	橄榄
omelet	煎蛋卷
Omelet	煎蛋卷
on	上
On	上
ON	上
once	一旦
Once	一旦
one	一
One	一
Oneonta	奥尼昂坦
ones	那些
Ones	那些
onion	洋葱
onions	洋葱
only	只要
Only	只要
onstage	在舞台上
Onstage	在舞台上
onto	到
Oo	吴
ooh	嚯
Ooh	哦
Oooh	哦
OoohhOoohh	喔
O-o-o-okayO-O-O-	好吗
Oooooh	哇
Ooooooh	噢
oop	接力
Oops	哎呀
oozing	渗血
op	运
Op	欧普
open	打开
Open	打开
opened	打开
opening	开盘
Opening	开盘
opens	打开
Opens	打开
opera	歌剧
operas	歌剧
operating	操作
opinion	意见
opp	奥普
opportunity	机会
opposite	相反
option	选项
options	选项
or	要么
Or	要么
orange	橙子
Orange	橙子
oranges	桔子
orchard	果园
order	订购
Order	订购
ordered	有序
ordering	排序
ordinary	普通
Oreo	奥利奥
Oreos	奥利奥
orginally	本来
orgy	狂欢
Orgy	狂欢
Orient	东方
origin	起源
original	原版的
originally	本来
originated	起源
ornaments	首饰
ornate	华丽的
ostentatiously	夸张
other	其他
Other	其他
others	其他
otherside	另一边
otherwise	除此以外
Otherwise	除此以外
ottoman	奥斯曼帝国
Ouch	哎哟
oughta	现在应该
Ouija	占卜
oun	渔隐
our	我们的
Our	我们的
ourselves	我们自己
out	出
Out	退房
outa	欧塔
outdoor	户外
outer	外
outfit	配备
outisde	外
outlet	出口
outloud	响亮地
outreach	推广
outside	外
Outside	外
outstanding	优秀
outstide	外
outta	失控
oven	烤箱
Oven	烤箱
over	过度
Over	过度
overboard	落水
overcoat	大衣
overemphasizing	过分强调
overhead	高架
overhearing	偷听
overlap	交叠
overpriced	高估
overseas	海外
overslept	睡过头
over-the	过度的
overweight	超重
overwhelmed	不堪重负
overwhelms	淹没
ovulating	排卵
ow	流
Ow	嗷
owe	欠
owes	欠
own	拥有
owner	所有者
owns	拥有
P.S.	附
pacing	起搏
Pacino	帕西诺
pack	包
Pack	包
package	包
packed	打包
packet	包
packets	包
packing	填料
packs	包
Packs	包
pad	垫
pagan	异教徒
page	页
pager	呼叫器
pages	网页
Paging	分页
paid	支付
pain	痛
painful	痛苦
paint	涂料
painted	绘
painter	画家
paintings	绘画
pair	对
pairs	对
pajamas	睡衣
PAJAMAS	睡衣
pal	朋友
Palace	宫
palaeontologist	古生物学家
pale	苍白
paleontologist	古生物学家
paleontology	古生物学
palm	棕榈
pals	哥儿们
pan	泛
Pan	泛
pancake	饼子
pancakes	薄煎饼
panchetta	培根
panel	面板
panic	恐慌
panicked	惊慌失措
panics	恐慌
pans	锅
panther	豹
panties	衩
pants	裤子
Pants	裤子
panty	内裤
Paolo	保罗
paper	纸
papers	文件
paperwork	证件
parachute	降落伞
parade	游行
paramedics	医护人员
paranoid	偏执
pardon	赦免
parent	亲
parents	父母
Parents	父母
Paris	巴黎
park	公园
Park	公园
parked	停
parking	停车处
parlor	客厅
parlour	客厅
parrot	鹦鹉
part	部分
partially	部分
participating	参与
particular	特定
particularly	尤其
parties	派对
partly	部分地
partner	伙伴
partners	伙伴
parts	部分
party	派对
Party	派对
pass	通过
passed	通过
passenger	乘客
passengers	乘客
passes	通行证
Passes	通行证
passin	经过的
passion	情
passionate	多情
passionately	热情
passport	护照
Passport	护照
past	过去
pasta	意大利面条
pastry	糕点
pat	拍
patch	补丁
patented	专利
path	路径
pathe	帕泰
pathet	巴特
pathetic	可怜
Pathetic	青衫
patient	患者
patiently	耐心地
patio	庭院
Patrick	帕特里克
patrons	食客
pats	拍
Pats	爱国者
Patti	帕蒂
patting	拍着
Patting	拍着
Paul	保罗
Paulo	圣保罗
pause	暂停
Pause	暂停
pauses	暂停
Pauses	暂停
pay	工资
payback	回报
paying	付款
pays	支付
pea	豌豆
peace	和平
peach	桃子
Peach	桃子
peacock	孔雀
pearls	珍珠
peas	豌豆
peck	啄
pedals	踏板
pee	撒尿
peed	撒尿
peek	窥视
peeking	偷看
peeks	偷窥
Peel	剥
peep	窥视
Peep	窥视
peeper	偷窥者
peepers	偷窥者
peephole	窥视孔
peer	窥视
pees	小便
Peeves	皮皮鬼
pelt	毛皮
pen	钢笔
penache	鹭
pencil	铅笔
pencils	铅笔
pending	有待
penetrate	穿透
penguin	企鹅
Penguins	企鹅
peninsula	半岛
penis	阴茎
Penis	阴茎
Penn	佩恩
penny	一分钱
pens	笔
people	人
People	人
pepper	胡椒
Pepper	胡椒
percent	百分
perfect	完善
Perfect	完善
perfection	完美
perfectly	完美
perform	演出
performance	性能
performing	执行
performs	施行
perhaps	也许
Perhaps	也许
period	期
Perk	额外津贴
perky	自信的
permanent	常驻
per-se	每本身
person	人
personal	个人
personality	个性
personnel	人员
Personnel	人员
perspective	透视
persuade	说服
perturbed	忐忑
Peru	秘鲁
pet	宠物
Pet	宠物
Pete	皮特
Peter	彼得
petite	娇小
petrie	皮特里
pets	宠物
petticure	修脚
Petty	小气
Pfieffer	菲佛
Phase	相
Pheebs	菲比
phenomenal	非凡的
Phil	菲尔
Philly	费城
philosophically	哲学
Philosophically	从哲学
phlegm	痰
Phoebe	菲比
Phoebes	芙蓉坊
phone	电话
Phone	电话
phonebook	电话簿
phoning	中打电话
photo	照片
photos	相片
phrase	短语
physical	物理
physically	物理
physician	医师
pianist	钢琴家
piano	钢琴
pick	挑
picked	采摘的
pickin	接下去
picking	选择
Picking	选择
pickle	泡菜
pickles	泡菜
picks	精选
Picks	精选
picnic	野餐
picture	图片
pictures	图片
picturing	生动描述
pie	馅饼
Pie	馅饼
piece	片
pieces	件
pig	猪
pigeon	鸽子
pigeons	鸽子
pigs	猪
pile	桩
piles	痔
pill	丸
pillar	柱
pillars	支柱
Pillman	皮尔曼
pillow	枕头
pillowcase	枕套
pillows	枕头
pills	丸
Pilot	飞行员
pin	销
pinch	捏
ping	平
pink	粉
Pinky	粉红
pins	销
pioneers	开拓者
piqued	激起
pirate	海盗
pissed	生气
pit	坑
pitched	倾斜的
pitcher	投手
pitches	球场
pity	可怜
pizza	比萨
Pizza	比萨
place	地点
Place	地点
placenta	胎盘
places	地方
placing	配售
plague	鼠疫
plain	川
plan	计划
plane	平面
planet	行星
planetarium	天文馆
plank	板
planned	计划
planner	规划人员
planning	规划
plans	计划
plant	厂
plants	植物
plastic	塑料
plate	盘子
Plate	盘子
plates	板
platonic	柏拉图式的
platting	编结
Platting	编结
play	玩
Play	玩
Playboy	花花公子
played	发挥
player	播放机
players	玩家
playfully	开玩笑
playin	发挥
playing	播放
Playing	播放
plays	播放
Plays	播放
pleading	恳求
Pleading	起诉
pleasant	愉快
please	请
Please	请
pleased	满意
pleasure	乐趣
plenty	丰富
plese	普莱舍
plexiglass	有机玻璃
plops	扑通一声
pluck	采摘
plugged	插
plugging	堵漏
plugs	插头
plunge	跳水
plunk	普拉克
plus	加
Plus	加
pocket	口袋
Pocket	口袋
pocketbook	笔记本
pockets	口袋
Poconos	波科诺斯
poecelain	瓷
poem	诗
poems	诗
poet	诗人
poetry	诗歌
point	点
Point	点
pointer	指针
pointing	指点
Pointing	指点
points	点
Points	点
poke	戳
poker	扑克
pokes	捅
poking	戳
pole	极
police	警察
polish	抛光
Polish	抛光
polished	光
polisher	抛光机
polishing	抛光
politely	礼貌
pollo	波洛
poms	劲歌
pong	乒乓
pony	小马
poo	便便
pool	池
poor	较差的
pop	流行的
popcorn	爆米花
popping	啪
poppy	罂粟
pops	持久性有机污染物
popular	流行
porcelain	瓷
porch	门廊
pornA	片
portions	部
portrayal	画像
pose	提出
position	位置
positions	位置
positive	正
Posner	波斯纳
possibilities	可能性
possible	可能
possibly	或者
post	岗位
poster	海报
Postpone	推迟
posts	帖子
pot	锅
potato	土豆
Potato	土豆
potatoes	土豆
Potatoes	土豆
potential	潜在
pots	罐
Potter	制陶工人
Poughkeepsie	波基普西
Poulet	布莱
pounding	重击
pounds	英镑
pour	倾
poured	倒
pouring	浇注
pours	盆满钵满
Pow	战俘
power	功率
Power	功率
powerful	强大
practically	几乎
practice	实践
practicing	练
practising	练
Practising	执业
prank	恶作剧
pre-bouquet	预花束
precious	珍贵
Precision	精确
Pre-Cretaceous	预白垩纪
predicament	困境
pre-emptive	先发制人
pregnant	孕
Prehistoric	史前
premiere	首映
Premiere	首映
preparation	制备
prepare	准备
prepared	准备
preparing	准备
present	当下
Presenting	呈现
presents	礼物
Presents	礼物
president	主席
press	按
pressed	压制
presses	印刷机
Presses	压力机
pressing	紧迫
pressure	压力
pretend	假装
pretended	假装的
pretending	假装
Pretending	假装
pretends	假装
Pretensous	自命不凡
prettily	娇滴滴
pretty	漂亮
Pretty	漂亮
pretz	百力滋
pretzel	椒盐卷饼
prevent	防止
preventing	防止
prevents	防止
preview	预习
price	价钱
prices	价格
pricks	刺
priest	牧师
prime	主要
Princess	公主
print	打印
printer	打印机
printing	印花
private	私人的
Private	私人的
prize	奖
Prize	奖
probably	大概
Probably	大概
problem	问题
Problem	问题
problems	问题
proceed	继续
proceeds	收益
process	处理
processed	处理
processing	处理
processors	处理器
product	产品
production	生产
professional	专业的
profile	轮廓
program	程序
progress	进展
progresses	进展
progressing	进展
projections	预测
prom	舞会
Prom	舞会
promise	诺言
Promise	诺言
promised	许诺
promptly	及时
prompts	提示
pronounce	发音
pronounces	宣告
proofs	样张
proposal	提案
props	道具
prospect	展望
protest	抗议
proud	骄傲
proudly	傲然
prove	证明
proves	证明
provide	提供
provided	提供
proving	证明
provocatively	挑逗
pry	撬
psycho	心理
psychological	心理
psychopath	精神病患者
public	上市
puck	冰球
PUCK	冰球
puddin	布丁
puddle	水坑
puff	噗
puling	蒲凌
pull	拉
pulled	拉
pulling	拉
pulls	拉
Pulls	拉手
pumped	抽
pumpkin	南瓜
punch	冲床
Punch	冲床
punches	拳
puppet	木偶
puppets	木偶
puppy	小狗
purchase	采购
pure	纯
purple	紫色
purpose	目的
purse	钱包
purses	皮包
push	推
Push	推
pushed	推
pushes	推
Pushes	推
pushing	推动
pushy	富有进取心的
put	放
Put	放
puts	看跌期权
Puts	看跌期权
putting	把
Putting	把
puzzle	难题
puzzled	困惑
pyjama	睡衣
quack	嘎嘎
Quack	嘎嘎
quacking	还会发出叽叽嘎嘎
quacks	江湖医生
qualifications	资格
qualifies	素质要求
quality	质量
quarterback	四分卫
quarters	住处
quartet	四重奏
Quartz	石英
que	阙
queen	女王
question	题
questioning	疑问
questioningly	诧异
questions	问题
quiche	乳蛋饼
quick	快
Quick	快
quicker	更快
quickie	匆匆
quickly	很快
Quickly	很快
quiet	安静
quieter	安静
quietly	悄悄
Quietly	悄悄
quiets	平静下来
quin	之五
Quincy	昆西
quit	放弃
Quit	放弃
quite	相当
quitters	戒烟
quitting	戒烟
quiz	测验
quizzical	探询
quizzically	疑惑
rabbi	拉比
rabbit	兔子
rabbits	兔
race	种族
racecar	赛车
Rach	瑞秋
Rachel	雷切尔
rack	架
racket	球拍
rackets	球拍
racquet	球拍
racquetball	壁球
Racquetball	壁球
radiator	散热器
radio	无线电
raid	袭击
railing	栏杆
rain	雨
Rain	雨
Rainbow	彩虹
Raindrops	雨滴
raining	下雨
rainy	多雨的
Rainy	多雨的
raise	提高
raises	加薪
raisin	葡萄干
raising	提高
Ralph	拉尔夫
rambled	天马行空
ramp	舷梯
ran	跑
Rangers	流浪者
raspberry	覆盆子
rat	鼠
rather	宁
rattled	叮叮当当
rattles	摇铃
Rattles	摇铃
raved	妄言
Raven	掠夺
ravioli	馄饨
ray	射线
re	回覆
're'	回覆
reach	达到
reached	到达
reaches	到达
Reaches	河段
reaching	到达
react	应对
reacting	反应
reaction	反应
reacts	发生反应
read	读
Read	读
readies	准备时间
reading	读
Reading	读
reads	读
Reads	读
ready	准备
Ready	准备
real	真实
Real	真实
realise	实现
realised	实现
realises	实现
Realises	实现
realising	实现
reality	现实
realization	实现
realize	实现
realized	实现
realizes	实现
Realizes	实现
realizing	实现
really	真
Really	真
reappears	重新出现
rear	后
reason	原因
reasons	原因
reassure	再保证
rebound	篮板球
recapping	重新盖上
receipt	收据
receive	接收
received	收到
receiver	接收器
recent	最近
recently	最近
reception	招待会
Reception	前台
receptionist	接待员
receptive	接受
recessional	休会
reciept	收据
recipe	食谱
recipes	食谱
recline	横卧
recliner	躺椅
recliners	躺椅
recognise	认识
recognises	识别
recoil	畏缩
recoils	反冲
recollection	回忆
recommend	推荐
record	记录
recorded	记录
Recording	记录
recover	恢复
recovering	恢复
rectangular	长方形
red	红色
Red	红色
redecorated	重新装修
Redford	雷德福
redials	重拨
redused	减少
Ree	稀土元素
reels	卷轴
reentering	重新进入
Reentering	重新进入
re-enters	重新进入
referee	裁判
refereeing	裁判
reference	参考
refering	闯民宅
refers	指
refill	充值
reflection	反射
refrain	副歌
refreshed	刷新
refrigerator	冰箱
refuse	垃圾
regard	看待
register	寄存器
regret	后悔
regroups	重新组合
Regular	定期
regulars	常客
rehearsal	排演
Rehearsal	排演
rehearsals	排练
rehearse	排练
rehearsing	排练
reimburse	补偿
reincarnated	转世
reject	拒绝
rejected	被拒绝
rejection	拒绝
rejoice	麾
rejoins	重新加入
relating	有关
relationship	关系
relationships	关系
Relative	相对的
relax	放松
Relax	放松
relaxed	轻松
relief	浮雕
relieved	安心
relived	重温
reluctant	不情愿
reluctantly	勉强
remaining	其余
remains	遗迹
remake	翻拍
remark	备注
remedy	补救
remember	记得
Remember	记得
remembered	记得
remembering	记忆
remembers	记得
remembrance	纪念
remind	提醒
reminds	提醒
remnants	残余
remodel	改装
RemorayRemoray	医生
Remore	遥远而明亮
remote	远程
Remotely	远程
remoto	偏远落后地区
remove	去掉
removed	去除
remover	卸妆
removes	移除了
removing	去除
Removing	删除
rent	出租
repacking	重新包装
repeat	重复
repeatedly	反复
repeats	重复
repeller	排斥
replace	更换
replaced	更换
replaces	取代
replacing	更换
report	报告
representation	表示
represents	代表
require	要求
required	需要
rerun	重新运行
rescue	拯救
research	研究
resembles	酷似
resembling	类似
Resenting	怨恨
resentment	怨恨
reservations	预订
resigned	辞职
resist	抗
resists	光刻胶
respective	各自
respond	响应
responding	响应
responds	响应
response	响应
responsibility	责任
rest	休息
restaurant	餐厅
Restaurant	餐厅
resting	休息
restraunt	餐厅
Restraunt	餐厅
restroom	卫生间
restrooms	厕所
rests	休息
result	结果
results	结果
resume	恢复
resumes	简历
retailers	零售商
retainer	定位器
retching	干呕
retiling	换瓦
retraction	回缩
retracts	缩回
retrained	再培训
retraining	再培训
retreats	务虚会
retrieved	检索
retrieves	检索
return	返回
returned	回
returning	回国
Returning	返回
returns	回报
Reunited	重逢
reveal	揭示
revealing	揭示了
Revealing	揭示了
reveals	揭示了
revenge	复仇
review	评论
reward	奖励
Rex	雷克斯
Rhodes	罗兹
Rhonda	朗达
rhyme	韵
rhythm	韵律
rhythmically	节奏
rib	肋
ribbed	罗纹
ribbon	带
rice	白饭
Rice	白饭
Richard	理查德
Richie	任贤齐
Rick	干草堆
rid	摆脱
ride	骑
Rider	骑士
ridge	岭
ridiculous	荒谬
riding	骑术
Riggs	里格斯
right	对
Right	对
righteous	正义
rights	权利
righty	右倾
rim	轮缘
ring	环
Ring	环
ringing	铃声
rings	戒指
Rings	戒指
rink	滑冰场
rinse	冲洗
ripped	撕开
ripping	翻录
rips	裂口
Rips	裂口
rises	上升
Ritter	里特尔
ritual	仪式
river	河
River	河
Rivera	里维拉
road	路
Road	路
roast	烤
Rob	抢
Robbie	罗比
Robbinson	罗宾逊
robe	长袍
Robert	罗伯特
Robin	知更鸟
robots	机器人
rock	岩石
Rock	岩石
Rockefeller	洛克菲勒
rocks	岩石
rod	竿
Rod	竿
rodeo	圈地
Roger	罗杰
Rogers	罗杰斯
role	角色
roll	滚
Roll	滚
roller	滚筒
Roller	滚筒
rollin	罗林
rolling	压延
rolls	劳斯莱斯
Rolls	劳斯莱斯
romantic	浪漫
Rome	罗马
Rona	罗纳
roo	袋鼠
roof	屋顶
Roof	屋顶
room	房间
Room	房间
roommate	室友
roommates	室友
rooms	客房
rooster	公鸡
rope	绳
rose	玫瑰
Rose	玫瑰
Rosen	罗森
roses	玫瑰
Ross	罗斯
ROss	罗斯
Ross.	罗斯
Rossa	罗萨
Rosselini	罗西里尼
rot	腐烂
rough	粗
Roughy	罗非鱼
round	回合
Round	回合
route	路线
Route	路线
row	行
Roy	罗伊
rub	擦
rubber	橡胶
rubbing	擦
rubdown	擦下来
rubs	磨
rug	地毯
rugby	橄榄球
ruin	废墟
ruined	毁了
rule	规则
rules	规则
rum	朗姆酒
run	跑
Run	跑
runnin	奔跑
running	赛跑
Running	运行
runs	运行
Runs	运行
rush	赶
Rush	赶
rushed	冲
rushes	七嘴八舌
rushing	冲
Rushing	冲
Rushmore	拉什莫尔
Russ	拉斯
Russian	俄语
Rust	锈
rusted	生锈
rut	发情
Ruth	怜悯
Ryan	瑞安
Ryder	莱德
s	小号
's	的
sacred	神圣
sad	伤心
saddened	悲痛
sadly	可悲的是
sadness	悲
safe	安全
safely	安然
safety	安全
said	说过
Said	说过
Sak	萨克
sake	清酒
Sal	萨尔
salad	沙拉
salads	沙拉
salesman	推销员
salmon	三文鱼
salmonella	沙门氏菌
salute	敬礼
Sam	山姆
same	相同
sample	样品
Sample	样品
San	圣
sand	砂
Sanders	桑德斯
sandwich	三明治
sandwiches	三明治
Sandy	沙
sane	明智的
sang	唱
sangria	西班牙果酒
Sanskrit	梵文
Santa	圣诞老人
SAP	树液
Sarah	莎拉
Saratoga	萨拉托加
sarcastic	讽刺
Sarcastic	讽刺
sarcastically	讽刺
sarcasticly	讽刺
satellite	卫星
Satin	缎
satisfaction	满足
satisfied	满意
satisfying	满意的
Saturday	星期六
sauce	酱
saucepan	平底锅
saucer	茶托
saucy	俏皮
save	保存
saved	保存
saver	保护程序
savings	储
savor	品尝
saw	锯
Saw	锯
say	说
Say	说
sayin	在说
saying	话
says	说
Says	说
scale	规模
scampering	疾走
scampers	跑过来
scare	吓
scared	害怕
Scared	害怕
scares	恐慌
scarf	围巾
scaring	疤痕
Scarsdale	斯卡斯代尔
scarves	围巾
scary	害怕
scatter	分散
scene	现场
Scene	现场
Monica	场景
scenes	场景
schedule	时间表
schizophrenia	精神分裂症
school	学校
School	学校
schoolboy	男生
schools	学校
Schwimmer	施维默
Science	科学
scientist	科学家
scientists	科学家们
scissors	剪刀
scones	司康饼
scooch	挤一挤
scoops	勺
score	得分了
Score	得分了
scores	分数
scornful	轻视
scotch	苏格兰人
Scotch	苏格兰人
Scott	斯科特
SCOUT	侦察
scowling	愁眉不展
Scrabble	乱涂
scrambles	争
Scranton	斯克兰顿
scrape	刮
scrapes	擦伤
scrapping	报废
scratches	划痕
scratching	搔抓
scream	惊叫
screamed	尖叫
screaming	尖叫
Screaming	尖叫
screams	尖叫声
Screams	尖叫
screeches	尖叫
screeching	尖叫
screen	屏幕
screw	拧
screwed	拧
screws	螺丝
script	脚本
scrubbing	擦洗
scrum	争球
sculpture	雕塑
Sean	肖恩
search	搜索
searches	搜索
Searches	搜索
searching	搜索
Seasame	芝麻
season	季节
Season	季节
seat	座位
seatbelts	安全带
seated	坐在
seats	席
sec	秒
second	第二
seconds	秒
secret	秘密
secretary	秘书
secretive	隐秘
secretly	偷偷
section	部分
sections	部分
security	安全
seduce	勾引
seductive	妖媚
see	看到
See	看到
seed	种子
seeing	眼看
Seeing	眼见
Seek	寻求
seem	似乎
seems	似乎
seen	看到
sees	看到
Sees	看到
seize	抢占
seizing	抓住
selection	选择
self	自
self-absorbed	自行吸收
selfish	自私
sell	卖
selling	销售
semen	精液
send	发送
sEnd	发送
sends	发送
sense	感
sensed	感应
sensitive	敏感
sent	发送
sentiment	情绪
separate	分离
separated	分离
sequence	序列
Sequence	序列
Sergei	谢尔盖
series	系列
serious	严重
seriously	认真地
Seriously	认真地
seriousness	严肃
serve	服务
served	提供服务
serves	供应
service	服务
services	服务
Services	服务
serving	服务
session	会议
set	组
sets	套
Sets	集
setting	设置
settle	解决
settled	安定
settles	结算
seven	七
seventeen	十七
Seventy	七十
several	一些
sewage	污水
sewn	缝制
sex	性别
Sex	性别
sexual	有性
Sexually	性
sexy	性感的
Sh	嘘
shade	阴凉处
shadow	阴影
shaft	轴
shake	抖动
shakes	奶昔
Shakes	奶昔
shaking	发抖
Shaking	发抖
Shall	应
shame	耻辱
Shame	耻辱
shampoo	洗头
shape	形状
shaped	成形
shapely	身材匀称
share	分享
shared	共享
sharing	分享
shark	鲨鱼
sharp	尖锐
shave	刮胡子
shaving	刮
she	她
She	她
shed	棚子
sheep	羊
sheepish	羞怯
sheepishly	羞怯地
sheet	片
shelf	架
shell	贝壳
Shelley	雪莱
shells	炮弹
Shelly	雪莉
shelter	庇护
Shes	畲族
shh	嘘
Shh	嘘
Shh.	嘘
shhh	嘘
Shhh	嘘
shhh.	嘘
shield	屏蔽
Shields	希尔兹
shifts	转移
shine	闪耀
shining	闪亮的
Shining	闪亮的
shiny	闪亮
shipped	运
shirt	衬衫
shirts	衬衫
shiver	发抖
shivering	发抖的
shock	休克
shocked	吃惊
Shocked	吃惊
shoe	鞋
shoebox	鞋盒
shoelaces	鞋带
shoes	鞋
Shoo	嘘
shoot	射击
Shoot	射击
shooting	射击
shoots	芽
shop	店
Shop	店
shopping	购物
shops	商店
short	短
Short	短
shorter	短
Shortly	不久
shorts	短裤
shot	射击
Shot	射击
shotgun	滑膛枪
shots	镜头
should	应该
Should	应该
shoulder	肩
shoulders	肩膀
shouldnt	不应该
shout	喊
shouting	叫喊
Shouting	呐喊
shouts	长啸
Shouts	公开发言
shovel	铲
shoves	塞到
show	节目
Show	节目
showdown	摊牌
showed	显示
shower	淋浴
showers	阵雨
showgirl	歌女
showing	展示
Showing	显示
shown	显示
showroom	展厅
shows	节目
Shows	展会
shrimp	虾
shrink	收缩
shrug	耸
shrugs	举重若轻
Shrugs	举重若轻
shuddering	发抖的
shuffles	洗牌
shushing	嘘
shut	关闭
Shut	关闭
shuts	启闭
Shutting	关闭
shy	害羞
shyly	害羞地
sick	生病
Sick	生病
sickness	疾病
side	侧
sidewalk	人行道
sideways	侧身
Sidney	西德尼
Siegal	西耶戈尔
sifting	筛选
sigh	叹
Sighing	叹了口气
sighs	叹息
sight	视力
sights	景点
sign	标志
Sign	标志
signa	西尼亚
signal	信号
signals	信号
signature	签名
signed	签
signify	表示
signifying	表意
signing	签约
silence	安静
Silence	安静
silent	无声
silently	默默
silly	愚蠢
silver	银
Silverman	西尔弗曼
silverware	银器
similar	类似
similarly	同样
Simon	西蒙
simple	简单
simply	只是
simulate	模拟
simulating	模拟
simultaneously	同时
since	以来
Since	以来
sing	唱
singer	歌手
singers	歌手
singin	登录
singing	唱歌
Singing	唱歌
single	单
sings	唱
sink	下沉
sinks	汇
sip	啜
sir	先生
Sir	先生
siren	警笛
sirens	警报器
sister	妹妹
Sister	妹妹
sisters	姐妹
sit	坐
Sit	坐
sitcom	情景喜剧
sits	坐镇
Sits	坐镇
sitter	保姆
sitting	坐在
Sitting	坐在
situation	情况
situps	仰卧起坐
six	六
sixes	乱七八糟
sixteen	十六
sixteenth	第十六
sixth	第六
sixty	六十
Sixty	六十
size	尺寸
sizes	大小
skate	滑冰
skates	冰鞋
skedaddle	斯基达德尔
skiing	滑雪
skills	技能
skin	皮肤
skinny	枯瘦
skins	皮
skirt	短裙
skis	滑雪板
skull	头骨
sky	天空
Skywalker	天空步行者
slam	猛撞
slammed	抨击
slamming	猛击
slams	抨击
Slams	大满贯
slant	倾斜
slap	拍击
slapping	打耳光
Slapping	拍
slaps	拍打
slash	削减
sleep	睡觉
Sleep	睡觉
sleepers	枕木
sleepily	睡眼惺忪
sleeping	睡眠
sleeps	睡觉
Sleeps	睡
sleeve	袖
sleighbells	雪橇铃
slept	睡
slice	切片
slices	片
Slickers	滑头
slide	滑动
slides	幻灯片
Slides	幻灯片
sliding	滑动
slight	轻微
slightly	略
Slightly	略
sling	吊绳
Slinky	苗条
slip	滑
slippers	拖鞋
slipping	滑倒
slips	卡瓦
slit	裂缝
sloppy	稀松
slow	慢
slowing	减缓
slowly	慢慢地
slumber	睡眠
slumping	暴跌
slumps	暴跌
slush	烂泥
Slut	懒妇
slyly	狡猾
smack	拍击
smacking	打孩子
smacks	嫌
small	小
Small	小
smaller	小
smallest	最少
smart	聪明
smashed	被砸
smeared	涂
smell	闻
Smell	闻
smelling	闻
smell-ly	闻
smells	气味
smelly	臭
Smelly	臭
smelt	冶炼
smile	微笑
Smile	微笑
smiles	笑容
Smiles	微笑
smiling	微笑
Smiling	微笑
smitten	重拳出击
smoke	抽烟
Smoke	抽烟
smoker	抽烟者
smokey	烟熏
smoking	抽烟
Smoking	抽烟
smooth	平滑
Smooth	平滑
snack	小吃
Snack	小吃
snake	蛇
snap	卡
snappily	没好气
snapping	捕捉
snaps	按扣
snatch	抢夺
snatches	防抢
Snatches	防抢
sneak	潜行
sneakers	球鞋
sneakin	潜入
sneaking	鬼鬼祟祟
sneaks	钻进
sneeze	喷嚏
sneezes	打喷嚏
Sneezes	打喷嚏
sneezy	打喷嚏
sniffing	嗅探
sniffs	嗅着
snore	鼾声
snoring	打鼾
snorts	酣畅
snow	雪
snowing	下雪
snowstorm	暴风雪
snowy	似雪
snug	舒适
Snuggles	挨近
so	所以
So	所以
soaked	浸泡
soap	肥皂
soaps	肥皂
soapy	肥皂水
sob	哭泣
sober	清醒
soccer	足球
Soccer	足球
society	社会
sock	袜子
socks	袜子
soda	苏打
sofa	沙发
sofabed	沙发床
soft	柔软的
softly	轻轻的
soilder	士兵
soir	晚报
sold	出售
solved	解决了
some	一些
Some	一些
somebody	谁
Somebody	谁
someday	日后
somehow	不知何故
someone	有人
Someone	有人
someplace	某个地方
somethin	事端
something	某物
Something	某物
sometime	某时
sometimes	有时
Sometimes	有时
somewhat	有些
somewhere	某处
somone	有人为
Somplace	某个地方
son	儿子
song	歌曲
song.	歌曲
songs	歌曲
sonogram	声像
soo	洙
Soo	洙
soon	不久
sooner	早
Soother	抚慰者
soothes	舒缓
soothing	抚慰的
Sophie	索菲
sophisticated	复杂的
sores	疮
sorrow	悲哀
sorry	抱歉
Sorry	抱歉
sort	分类
sorta	八九不离十
sound	声音
Sound	声音
sounded	满面
sounding	听起来
sounds	声音
Sounds	声音
soup	汤
sour	酸
souvenir	纪念品
soy	黄豆
space	空间
Spaceballs	太空炮弹
spaceship	飞船
spades	黑桃
spandex	斯潘德克斯弹性纤维
Spanish	西班牙语
spare	备用
Sparrow	麻雀
spatula	抹刀
speak	说话
speaker	扬声器
speaking	请讲
Speaking	请讲
speaks	说话
special	特别
Special	特别
specially	特别
specials	特价
speech	言语
speechless	说不出话来
Speed	速度
speedily	赶紧
spelled	拼写
spelling	拼字
spend	花
spender	富豪
spending	开支
spent	花费
sperm	精子
Spiderman	蜘蛛侠
spied	窥探
Spike	穗
spikes	钉鞋
spill	洒
spilled	洒
spilling	溢出
spills	泄漏
spin	纺
Spin	纺
spinach	菠菜
spinning	纺织
spins	自旋
spirit	精神
spit	吐
spits	吐奶
Spits	吐
spitting	随地吐痰
splashed	泼
split	分裂
splotches	斑点
Spock	斯波克
spoil	溺爱
spoiled	坏
sponge	海绵
sponsor	赞助
spooky	幽灵般的
spoon	勺
Spoon	勺
spoons	匙
sporting	运动的
sports	体育
spot	点
Spot	点
spots	斑点
spotting	斑点
spout	喷口
spray	喷雾
spraying	喷
sprays	喷雾剂
spread	传播
Spreading	传播
spreads	利差
spring	弹簧
sprint	短跑
sprinting	冲刺
sprints	冲刺
spritzer	汽酒
sprung	弹性
spun	纺
sputters	溅射
spy	间谍
spyhole	窥视孔
squabble	争吵
Squad	队
square	广场
Square	广场
squares	广场
squat	蹲
squatting	蹲
squawks	叫声
squeal	尖叫
squeals	尖叫声
Squeals	尖叫声
squeeze	挤
squeezed	挤压
squeezes	挤压
squeezing	挤压
squirming	蠕蠕
squirms	蠕动
squirts	鞘
Squirts	鞘
squish	果酱
squishing	压扁
squishy	糊状的
Sr.	高级
stab	刺
stack	堆
staff	员工
stage	阶段
staggered	交错
staggers	蹒跚
staging	分期
stain	弄脏
stairs	楼梯
Stalin	斯大林
stalk	茎
stalker	死缠烂打
stall	摊子
stamp	邮票
stand	支架
Stand	支架
standing	常设
Standing	常设
stands	站立
Stands	站立
stank	发臭
stapler	订书机
star	星
Star	星
Starbucks	星巴克
stare	盯
Stare	盯
stares	凝视
staring	凝视
starring	主演
stars	明星
start	开始
started	开始
starting	开始
Starting	开始
startled	怔
startles	惊人死不休
Startles	吓了他一跳
startling	触目惊心
starts	启动
Starts	启动
statement	声明
states	状态
States	状态
static	静态的
station	站
statue	雕像
Statue	雕像
stay	留
Stay	留
staying	住
stays	入住
steadily	稳步
steady	稳定
Steady	稳定
steak	牛扒
steaks	牛排
steal	偷
stealing	偷窃行为
steamed	蒸熟
steaming	腾腾
steamy	潮湿
steel	钢
steering	操舵
Steiger	斯泰格尔
Stella	斯特拉
step	步
Step	步
stepfather	后爹
Stephanie	斯蒂芬妮
Stephanopoulos	普洛斯
stepped	加强
stepping	步进
Stepping	步进
steps	脚步
Steps	脚步
stereo	立体声
stern	严肃
Steve	史蒂夫
Steven	史蒂芬
Stevens	史蒂文斯
stew	炖
stewardess	空中小姐
stick	棒
Stick	棒
sticking	症结
sticks	枝
sticky	黏
Sticky	黏
still	仍然
Still	仍然
STILL	仍然
Stiller	斯蒂勒
stingy	小气
stinks	臭
stir	搅拌
Stir	搅拌
stirring	搅拌
stirs	搅
stock	股票
stocked	库存
stocking	袜
stole	偷了
stolen	被盗
stomach	胃
stomachs	胃
stomp	跺脚
stomps	单块
stoned	砸死
stool	粪便
stools	凳子
stop	停
Stop	停止
STOP	停
stopped	停止
stopping	停止
stops	停止
Stops	停止
storage	存储
store	商店
Store	商店
stories	故事
storms	风暴
Storms	风暴
story	故事
Story	故事
straddles	多空套做
straddling	跨界
strafing	扫射
straight	直行
straighten	弄直
straightens	拉直
straining	使劲
strand	缕
stranded	搁浅
strange	奇怪
strangely	奇怪
stranger	陌生人
strangers	陌生人
strap	背带
straw	稻草
street	街
Street	街
streets	街道
stress	强调
stressing	强调
stretch	伸展
stretches	舒展
strides	进步
strike	罢工
string	串
strip	跳闸
stripped	剥离
stripper	脱衣舞
strippers	脱衣舞
strips	带子
strokes	招
stroking	行程
stroller	童车
strong	强大
stronger	强
strongly	非常
struck	来袭
structure	结构体
struggle	斗争
struggles	斗争
struggling	奋斗的
strung	串起
struts	支柱
stub	存根
stubs	存根
stuck	卡住
Stuck	卡住
student	学生
students	学生们
studio	工作室
studios	工作室
Studios	工作室
study	研究
stuff	东西
stuffers	灌肠机
stuffing	馅
stumped	难倒
stung	刺痛
Stung	刺痛
stunned	目瞪口呆
Stunned	目瞪口呆
Stunning	令人惊叹
stupid	笨
Stupid	笨
stupidity	糊涂事
stupidly	愣神
stuttering	口吃
stutters	口吃
style	样式
styles	款式
subject	学科
subway	地铁
Subway	地铁
succeeds	成功
successful	成功
successfully	顺利
such	这样
Such	这样
suck	吮吸
sucked	吸
suckle	哺乳
sucks	吸
sudden	突然
Sudden	突然
suddenly	突然
Suddenly	突然
suds	泡沫
suffering	痛苦
sugar	糖
Sugar	糖
suggesting	提示
suggestion	建议
suicide	自杀
suit	适合
suitcase	手提箱
suitcases	手提箱
suited	合适的
suits	西装
sullenly	绷着脸
summer	夏季
Summer	夏季
summertime	夏令
Sumo	相扑
Sumter	萨姆特
sun	太阳
Sunday	星期日
sung	盛
Sung	宋
sunglasses	墨镜
sunset	日落
Sunshine	阳光
super	超
superiors	上级
supermodels	超级名模
supervision	监督
supervisor	监
supply	供应
support	支持
supportive	支持
suppose	假设
supposed	应该
sure	当然
Sure	当然
surface	表面
surgery	手术
surgical	外科
surprise	惊
Surprise	惊
surprised	诧异
Surprised	诧异
surprisingly	出奇
surreal	超现实主义
surrounding	周围
survive	生存
survived	幸存
survivor	幸存者
Susan	苏珊
Susans	舒尚
sushi	寿司
Susie	苏西
suspected	嫌疑
swallow	吞
swallowed	吞食
swallows	燕子
swans	天鹅
swap	交换
swaps	掉期交易
swats	次封盖
Sways	摇摆
swear	发誓
Swears	发誓
sweat	汗
sweater	毛线衣
sweaters	毛衣
sweating	出汗
sweats	盗汗
sweatshirt	运动衫
sweaty	出汗
sweep	扫
Sweep	扫
sweeping	笼统的
sweeps	扫描
Sweeps	扫
sweet	甜
Sweet	甜
sweetest	甜蜜
sweetheart	爱人
Sweetheart	爱人
sweetie	糖果
Sweetie	糖果
sweetly	甜蜜
sweetness	甜美
swiftly	如飞
swig	痛饮
swill	泔水
swim	游泳
swimmer	游泳者
swimming	游泳的
swing	摇摆
swinging	摆荡
Swinging	摆荡
swings	波动
swirly	旋涡状
switch	开关
switched	交换的
switches	开关
switching	交换
swoop	落下
swoops	猛扑
swordfish	旗鱼
swore	发誓
sycophant	拍马屁的人
syllable	音节
symbol	符号
sympathetic	有同情心
sympathetically	怜悯地
sympathize	同情
sync	同步
syphilis	梅毒
syrup	糖浆
Syrup	糖浆
system	系统
Ta	钽
table	表
tableau	画面
tables	表
tabletop	桌上
tacked	上涨
tackle	滑车
tackled	解决
tackles	铲球
tacky	俗气的
taco	塔科
Taco	塔克
tactlessness	木纳
tail	尾巴
tailor	裁缝
tailpipe	排气管
tainted	污点
take	采取
Take	采取
taken	采取
takes	需要
Takes	需要
takin	羚牛
taking	服用
Taking	以
Talent	天赋
talented	天才
talentless	无能
talk	谈论
Talk	谈论
talked	谈
talkin	说话
talking	说
Talking	说
talks	会谈
tall	高
taller	高
tallies	吻合
Tampa	坦帕
tampons	棉球
tangled	紊
tangling	缠结
tank	罐
Tank	罐
tanked	喝醉的
Tanya	蔡健雅
tap	龙头
tape	胶带
taped	录音
tapes	磁带
tapping	窃听
Tapping	窃听
taps	水龙头
Taps	丝锥
tarp	篷布
Tartlets	馅饼
Tarzan	泰山
taste	味道
tasted	尝
tasteless	无味
tastes	口味
Tastes	口味
tasting	品尝
Tate	泰特
tattoo	黥
Tattoo	黥
tattoos	纹身
taught	教
taxi	出租车
Taxi	出租车
tea	茶
teach	教
teacher	老师
teaches	教
teaching	教学
team	球队
tear	眼泪
tearful	内牛满面
tearfully	含泪
Tearfully	含泪
tearing	撕裂
tears	眼泪
technically	技术上
technology	技术
Ted	摊晒
teddy	泰迪熊
teen	青少年
teenage	青少年
teeny	蝇头
teeth	牙
tele	远程
telepathic	心灵感应
telephone	电话
telescope	望远镜
television	电视
tell	告诉
Tell	告诉
tellin	泰兰
telling	告诉
tells	告诉
temple	寺庙
temples	寺庙
temporarily	暂时
ten	十
Ten	十
tended	往往
tender	投标
tenderly	温柔
tennis	网球
tenses	时态
tentatively	姑且
tenth	第十
tepid	不温不火
tequila	龙舌兰酒
term	术语
terminal	终奌站
terms	条款
terrace	阳台
terrible	可怕
Terribly	可怕
terrific	了不起
terror	恐怖
terrorised	恐吓
Terry	特里
test	测试
testing	测试
testosteroney	睾酮
tests	测试
th	日
Th	钍
Thames	泰晤士
than	比
thank	谢谢
Thank	谢谢
thanking	表达感谢
thanks	谢谢
Thanks	谢谢
Thanksgiving	感恩
thankyou	谢谢
that	那
That	那
thats	那是
Thats	那是
the	该
The	该
theatre	剧院
Theatre	剧院
thee	你
their	其
Their	其
them	他们
Them	他们
theme	主题
themselves	他们自己
then	然后
Then	然后
theoretically	理论上
theory	理论
there	那里
There	那里
theres	有
thermos	热水瓶
these	这些
These	这些
they	他们
They	他们
theyre	他们是
thief	贼
thieving	偷窃
thigh	大腿
thing	事情
things	事
Things	事情
thingy	啄
think	认为
Think	认为
thinkin	想着
thinking	思维
Thinking	思维
thinks	想
Thinks	想
thinner	更薄
third	第三
Third	第三
thirsty	渴
thirty	三十
Thirty	三十
this	这个
This	这个
Tho	芹苴
Thomas	托马斯
thong	丁字裤
thorn	刺
those	那些
Those	那些
though	虽然
Though	虽然
thought	思想
Thought	思想
thoughtful	周到
thoughts	思念
thousand	千
thousands	数千
thread	线
Thread	线
three	三
Three	三
Threesome	三人组
threw	扔
Thrilled	高兴
thro	救援人员到场
Thro	救援人员到场
throat	喉
through	通过
throw	扔
throwing	投掷
thrown	抛出
throws	投
Throws	抛出
thud	轰的一声
thumb	拇指
thumbs	大拇指
thumbtack	图钉
Thurman	瑟曼
Thursday	星期四
thy	你的
tick	蜱
ticket	票
ticketed	票款
tickets	门票
Tickets	门票
ticking	滴答
tie	领带
Tie	领带
tied	绑
tiered	分层
ties	联系
Ties	领带
tiger	虎
tigers	老虎
tight	紧
tighter	更紧
tightly	紧紧
Tiki	蒂基
til	胡麻
tile	瓦
tiles	瓷砖
till	直到
Tilly	蒂莉
tilt	倾斜
tilting	倾斜
tilts	倾斜
Tim	蒂姆
time	时间
Time	时间
timer	计时器
Timer	计时器
times	时
Times	时
timing	定时
tin	锡
tinfoil	锡纸
tingling	麻
Tinker	修补匠
tinkle	叮当声
tinsel	箔
tiny	小
Tiny	小
tip	小费
tipped	尖
tipping	小费
tips	提示
tired	累
tires	轮胎
tissue	组织
Tissue	组织
tit	山雀
title	标题
titling	所有权
to	至
To	至
toast	烤面包
Toblerone	三角巧克力
Toby	托比
today	今天
Today	今天
toe	脚趾
Toe	脚趾
toes	脚趾
together	一起
toilet	厕所
toiletries	化妆品
told	告诉
toliet	厕所
tomato	番茄
tomatoes	番茄
Tommy	汤米
tomorrow	明天
Tomorrow	明天
tone	音
tones	音
tongue	舌
tongues	舌头
tonight	今晚
Tonight	今晚
tons	吨
tonsils	扁桃体
Tony	托尼
too	太
Too	太
took	拿
tool	工具
tools	工具
tooth	齿
toothbrush	牙刷
toothless	无牙
Tootsie	窈窕淑男
top	最佳
tore	撕毁
torn	撕裂
torso	躯干
torture	拷打
toss	折腾
tosses	抛
Tosses	扔
tossing	折腾
total	总
totally	完全
Totally	完全
tots	切块
touch	触摸
touchdown	接地
touchdowns	达阵
touched	感动
Touched	感动
touches	触摸
touching	接触
touchy	易怒的
tough	强硬
toughest	最艰难的
tounge	舌头
tour	游览
tourists	游客
Tourists	游客
tournament	比赛
tow	拖
TOW	拖
toward	往
towards	向
towel	毛巾
towels	毛巾
town	镇
toy	玩具
track	跟踪
tracks	轨道
trade	贸易
trading	贸易
traditional	传统
traffic	交通
trail	落后
trails	步道
train	培养
trained	熟练
trainer	训练者
trainers	培训师
training	训练
trains	火车
tranquiliser	镇静剂
Transcriber	誊写
transferred	转移
transferring	转移
Transit	过境
translates	转换
translator	翻译者
Translucent	半透明
trapped	被困
trapping	诱捕
traps	陷阱
trash	垃圾
trashy	没用
travel	旅行
Travel	旅行
Traveller	旅客
travels	旅行
Travis	特拉维斯
tray	托盘
trays	盘
treadmill	跑步机
treasure	宝藏
treasures	珍品
treat	对待
treats	对待
tree	树
Treeger	倒真
trees	树木
Trek	跋涉
triangle	三角形
Trib	论坛报
Tribbiani	昂尼
Tribianni	昂尼
trick	特技
tricking	淋水
tricks	技巧
tricky	狡猾
tried	试着
tries	尝试
Tries	尝试
trio	三人
trip	旅
Triple	三倍
tripping	跳闸
trips	旅行
triumph	胜利
triumphantly	胜利地
Triumphantly	胜利地
troop	部队
trophy	杯
tropical	热带
Trots	小跑
trouble	麻烦
troubles	麻烦
truck	卡车
true	真正
truly	真
trust	信任
trusted	信任
trusts	信托
truth	真相
try	尝试
Try	尝试
tryin	试着
trying	试
Trying	试
T-shirtT	恤衫
Tso	左宗棠
tub	桶
tube	管
tub-o-popcorn	浴缸邻爆米花
Tuesday	星期二
tug	拖船
Tuna	金枪鱼
tune	调
tunes	曲调
tunnel	隧道
turkey	火鸡
turkeys	火鸡
turn	转
turned	转身
turning	车削
Turning	车削
turns	圈
Turns	圈
Turtle	龟
Tuscadero	塔斯卡德罗
tutti	合奏
Tuttle	塔特尔
tv	电视
TV	电视
TV.	电视
tweezers	镊子
Tweezers	镊子
twelve	十二
Twelve	十二
twenty	二十
Twenty	二十
twice	两次
twin	双胞胎
twinkie	小女生
twinkling	闪烁
twinkly	闪烁的
twins	双胞胎
twist	捻
twisted	扭曲
Twister	倍捻机
twists	曲折
two	二
Two	二
tying	搭售
Tyler	泰勒
type	类型
typical	典型
Tyrannosaurus	暴龙
ugh	啊
Ugh	啊
ugly	丑陋
Ugly	丑陋
uh	呃
Uh	呃
uhh	嘘
Uhh	呃
Uhhh	唔
uh-huh	嗯
Uh-huh	嗯
Uh-huuuuh	嗯
Uhl	乌尔
uh-oh	嗯
Uh-oh	嗯
uh-ohhh	嗯
Ultimate	最终
ultimatum	最后通牒
ultrasound	超声
Um	庵
Uma	乌玛
umbrella	雨伞
umm	乌姆
Umm	乌姆
ummm	嗯
Ummm	嗯
unable	无法
unamused	垂头丧气
Unbearable	不堪忍受
unbelievable	难以置信的
Unbelievable	难以置信的
unbelievably	令人难以置信
Unbound	不作承诺
uncalled	多余
uncertain	不确定
Uncle	叔叔
unclogging	清通
uncomfortable	不舒服
uncomprehending	不可理喻
unconcerned	漠不关心
unconsciously	不知不觉
uncontrollably	失控
under	下
underlines	下划线
underneath	下
underpants	内裤
understand	了解
understanding	理解
understands	理解
understood	了解
underway	进行
underwear	内衣
undisturbed	不受干扰
undone	未完成
Undone	未完成
undressing	脱衣
uneasily	不安
uneasy	不安
unemployed	失业的
uneven	不均匀的
unfair	不公平
unfaithful	不忠
unfinished	未完成
unfortunate	不幸的
unfortunately	不幸
Unfortunately	不幸
unfulfilling	不过瘾
unhooked	脱钩
uniform	制服
Unimpressed	不为所动
unintelligible	不知所云
unique	独特
unison	齐奏
unit	单元
United	联合的
unjustified	不合理
unless	除非
Unless	除非
un-like	联合国样
unlock	开锁
unlocks	解锁
un-meUN-	我
unnatural	不自然
unnoticed	被忽视
unpack	解压
unpacked	解压
unpacking	拆包
unprofessional	不专业
unpublished	未公布
unseen	看不见
unsure	不确定
until	直到
Until	直到
untrusting	不信任
unusual	异常
unveils	推出
unvoiced	清音
unwraps	解开
unyielding	不屈
up	向上
Up	向上
upcoming	即将到来
upfield	高场
upon	上
upper	上
upright	直立
upset	烦乱
upside	上边
upstairs	楼上
Upstairs	楼上
uptight	紧张
uptown	住宅区
urge	敦促
urged	敦促
urges	冲动
urinal	便池
urine	尿
urn	瓮
Ursula	乌苏拉
us	我们
USA	美国
use	使用
used	用过的
useless	无用
uses	使用
Uses	用途
usher	招待员
ushered	迎来
ushering	迎来
ushers	招待员
using	运用
Using	运用
usually	平时
Utah	犹他州
uterus	子宫
vacant	空的
vacuum	真空
vacuuming	吸尘
vaguely	依稀
valentine	情人节
Valentine	情人节
valid	有效
van	面包车
Van	面包车
vanilla	香草
variety	品种
various	各个
varnish	漆
vase	花瓶
Vase	花瓶
VCR	录像机
VCR.	录像机
ve	已经
Vegas	拉斯维加斯
vegetables	蔬菜
vegetarian	素
veil	面纱
veins	纹
Vell	贝尔
velociraptor	迅猛
Velvet	丝绒
vendor	供应商
vent	发泄
verbal	口头
verbs	动词
verge	边缘
Vermont	佛蒙特
Versachi	范思哲
verse	诗
Vertigo	眩晕
very	非常
Very	非常
vessel	容器
vest	背心
vestibule	前厅
vet	兽医
veteranarian	兽医
vibe	盛传
Vic	维克
vicious	恶毒
video	视频
Video	视频
April	视频
videos	视频
viejo	别霍
Vienna	维也纳
view	视图
vigorous	蓬勃
Village	村
Vince	文斯
violently	猛烈
Virgin	处女
virtual	虚拟
virtually	实质上
virus	病毒
Visa	签证
viscously	粘滞
visibly	明显地
visited	参观
visual	视觉
visually	视觉
voice	语音
voiceover	画外音
volleyball	排球
vomit	呕吐
voted	投
voyage	航程
Voyage	航程
vulnerable	弱势
Vulva	外阴
waddle	瓦德尔
waggles	扭来扭去
Wags	太太团
Wah	华
wails	哀号
waist	腰部
waistband	腰带
wait	等待
Wait	等待
waited	等待
waiter	服务员
waiters	服务员
waiting	等候
waitress	小姐
Waitress	小姐
waitressing	女服务生
Waitressing	女服务生
waits	等待
wake	唤醒
Wake	唤醒
wakes	醒来
waking	醒来
walk	步行
walked	走
Walker	助步车
walkin	步入
walking	步行
walkman	随身听
walks	散步
Walks	自助游
wall	壁
Wallace	华莱士
wallet	钱包
wallets	钱包
walls	墙壁
Waltham	沃尔瑟姆
wan	苍白
Wan	广域网
wandered	逛到
wandering	飘零
Wandering	流浪
wanders	漫步
wank	手淫
want	想
Want	想
wanted	通缉
wanting	希望
wants	希望
war	战争
War	战争
warm	暖
warming	变暖
warn	警告
Warren	养兔场
Wars	战争
was	是
Was	是
washer	垫圈
washing	洗涤
waste	浪费
wasted	浪费
watch	看
Watch	看
watcha	沃彻
watched	看着
watches	手表
watching	观看
Watching	观看
water	水
Water	水
waters	水域
wattles	肉垂
wave	波
Wave	波
wavers	动摇
waves	波浪
Waves	波浪
waving	挥手
wax	蜡
Wax	蜡
waxing	打蜡
way	办法
Way	办法
ways	方法
we	我们
We	我们
WE	我们
weak	弱
weakly	弱
wear	穿
wearin	穿着
wearing	穿着
wears	穿
weasel	黄鼠狼
website	网站
wedded	结婚
wedding	婚礼
Wedding	婚礼
weddings	婚礼
Weddings	婚礼
wedgies	坡跟
week	周
weekend	周末
weekends	周末
Weekly	每周
weeks	周
weenie	威尼
Weeper	爱哭鬼
weighin	称量体重
weight	重量
weights	权重
weird	奇怪的
weirdest	最奇怪的
welcome	欢迎
Welcome	欢迎
well	好
Well	好
welling	夺眶而出
Wendy	温迪
went	去
Went	去
were	是
Were	是
West	西方
Western	西
Westminster	威斯敏斯特
wet	湿
Wh	瓦
wha	世界卫生大会
Wha	什
whacked	疲惫不堪
Whacks	敲敲罢了
whaddya	那么
Whaddya	那么
whaling	捕鲸
Wham	重打
what	什么
What	什么
WHAT	什么
whatever	随你
whatsoever	任何
wheel	轮
Wheel	轮
wheels	车轮
when	什么时候
When	什么时候
whenever	每当
Whenever	每当
where	哪里
Where	哪里
wherever	哪里
whether	是否
Whew	呼
which	哪一个
Which	哪一个
Whichever	任何
whiff	喷气
while	而
While	而
whilst	同时
whim	怪念头
whincing	畏缩
whine	抱怨
whines	哼唧
whining	呜呜
whip	鞭子
whipped	鞭打
whips	鞭子
Whips	鞭子
whiskey	威士忌酒
whispering	耳语
Whispering	耳语
whispers	耳语
Whispers	私语
whistle	哨
whistles	口哨
whistling	吹口哨
white	白色
White	白色
whites	白人
whiz	呼啸
who	谁
Who	谁
whoa	哇
Whoa	哇
WHOA	哇
whoah	哇
Whoah	哇
whole	整个
Whole	整个
whom	谁
whoo	喔
Whoo	喔
whoops	哎呦
Whoops	哎呦
whore	妓女
whos	谁是
whose	谁的
why	为什么
Why	为什么
wide	宽
widow	寡妇
wife	妻子
wig	假发
wiggles	晃
wild	野生
Wild	野生
wildly	疯狂
will	将
Will	将
Williams	威廉姆斯
willing	愿意
win	赢得
winces	畏缩
wind	风
winding	曲折
window	窗口
windows	视窗
Windows	视窗
wine	葡萄酒
Wine	葡萄酒
wings	翅膀
wink	眨眼
winning	胜利
Winona	薇诺娜
wins	胜
wipe	擦拭
wiped	抹
wipes	湿巾
Wipes	湿巾
wiping	擦
wire	线
wish	希望
Wish	希望
wishes	祝福
wishing	希望
Wistfully	望眼欲穿
witch	巫婆
with	同
With	同
within	内
without	无
Without	没有
witticism	妙语
wizard	巫师
Wo	禾
woah	哇
Woah	哇
woes	困境
woke	醒来
woken	唤醒
woman	女人
Woman	女人
women	妇女
Women	妇女
won	韩元
wonder	奇迹
wonderful	精彩
wondering	想知道
wonders	奇迹
wondrous	奇妙
Wong	皇
wont	惯于
woo	求爱
Woo	求爱
wooden	木
Wooh	呜
wool	羊毛
word	字
wordless	无言
words	话
wore	穿着
work	工作
Work	工作
worked	工作
worker	工人
workin	干活
working	工作的
works	作品
world	世界
worm	虫
worried	担心
worry	担心
worrying	令人担忧
worse	更差
worsened	恶化
worst	最差
worth	价值
Worth	价值
would	将
Would	将
wound	伤口
wow	哇
Wow	哇
wrapped	包裹
wrecked	失事
wrestling	摔角
wrinkle	皱纹
wrist	腕
write	写
writer	作家
writes	写
Writes	写
writing	写作
written	书面
wrong	错误
Wrong	错误
wrongly	错
wrote	写
wth	问心无愧
wuss	肉脚
Xerox	复印
X-FilesX	档案
ya	亚
Ya	雅
Yamaguchi	山口
yams	山药
yanking	唬弄
Yanni	雅尼
yarn	纱
yas	亚斯
Yasmine	亚斯曼
yaw	偏航
Yawning	打哈欠
yawns	打哈欠
yay	好极了
Yay	好极了
ye	你们
yea	是啊
yeah	是啊
Yeah	是啊
year	年
Year	年
yearbook	年鉴
yearly	每年
years	年份
yeh	叶
yell	叫喊
Yeller	黄狗
yellin	喊
yelling	大呼小叫
Yelling	叫喊
yellow	黄色
yells	破口大骂
yelp	喊叫
Yemen	也门
yep	是的
Yep	是的
yes	是
Yes	是
YES	是
yesterday	昨天
yet	然而
Yikes	哎呀
y'know	你知道
Y'know	你知道吗
yo	哟
Yo	哟
yoghurt	酸奶
yogurt	酸奶
Yoko	洋子
York	纽约
you	您
You	您
YOU	您
Y-O-U-apostropheY-O-U-	撇号
young	年轻
younger	更年轻
your	您的
Your	您的
Y-O-U-R	您的
youre	你是
Youre	你是
yours	你的
yourself	你自己
youself	你自己
youth	青年
Ys.	伊苏
Yuh	裕
yuk	议员
yum	百胜
yummy	好吃
Yummy	好吃
Yup	对
Zachary	扎卡里
Zana	扎娜
Zane	赞恩
zillionaire	兆亿富翁
zip	压缩
zipper	拉链
zips	拉链
zone	区
zones	区
zoo	动物园
Zoo	动物园
zoom	放大
zooms	缩放
balls	球
Balls	球
ban	禁止
banana	香蕉
bananas	香蕉
band	乐队
bandaged	缠着绷带
bang	爆炸
incense	香
inch	英寸
